timestamp,type,description,debit,credit,balance
2021-07-03 18:08:54.810101+00:00,subscription,SUBSCRIPTION,0.0,1000.0,1000.0
2021-06-26 00:36:00+00:00,symbol_transaction,BUY LONG 22.93917334101031 BINANCE-DEGOUSDT 4.362 26/06/2021,100.16073478760046,0.0,899.8392652123996
2021-06-26 00:48:00+00:00,symbol_transaction,SELL LONG 22.93917334101031 BINANCE-DEGOUSDT 4.367 26/06/2021,0.0,100.08,999.91
2021-06-26 01:13:00+00:00,symbol_transaction,BUY LONG 23.18745460256113 BINANCE-DEGOUSDT 4.308 26/06/2021,99.99144598226117,0.0,899.9230138403502
2021-06-26 01:39:00+00:00,symbol_transaction,BUY LONG 23.39553782021668 BINANCE-DEGOUSDT 4.26 26/06/2021,99.76465610523718,0.0,800.158357735113
2021-06-26 02:26:00+00:00,symbol_transaction,BUY LONG 23.488683267189504 BINANCE-DEGOUSDT 4.217 26/06/2021,99.15082911507587,0.0,701.0075286200371
2021-06-26 02:27:00+00:00,symbol_transaction,BUY LONG 23.606931010763706 BINANCE-DEGOUSDT 4.201 26/06/2021,99.27188989339453,0.0,601.7356387266425
2021-06-26 02:30:00+00:00,symbol_transaction,BUY LONG 23.75693340676556 BINANCE-DEGOUSDT 4.188 26/06/2021,99.5935311446417,0.0,502.1421075820008
2021-06-26 02:59:00+00:00,symbol_transaction,BUY LONG 23.675642834153617 BINANCE-DEGOUSDT 4.199 26/06/2021,99.51343828487164,0.0,402.62866929712914
2021-06-26 03:01:00+00:00,symbol_transaction,BUY LONG 23.687542084868166 BINANCE-DEGOUSDT 4.202 26/06/2021,99.63458689245665,0.0,302.9940824046725
2021-06-26 03:03:00+00:00,symbol_transaction,BUY LONG 23.661777488651232 BINANCE-DEGOUSDT 4.212 26/06/2021,99.76307018898119,0.0,203.2310122156913
2021-06-26 03:22:00+00:00,symbol_transaction,BUY LONG 22.799733136927557 BINANCE-DEGOUSDT 4.16 26/06/2021,94.94173673946825,0.0,108.28927547622304
2021-06-26 05:04:00+00:00,symbol_transaction,SELL LONG 23.47975264256842 BINANCE-DEGOUSDT 4.254 26/06/2021,0.0,99.78,208.07
2021-06-26 05:36:00+00:00,symbol_transaction,BUY LONG 23.47975264256842 BINANCE-DEGOUSDT 4.197 26/06/2021,98.64306636270052,0.0,109.4291939872671
2021-06-26 10:42:00+00:00,symbol_transaction,SELL LONG 24.345555694500508 BINANCE-DEGOUSDT 4.086 26/06/2021,0.0,99.38,208.81
2021-06-26 10:57:00+00:00,symbol_transaction,BUY LONG 23.770475101655776 BINANCE-DEGOUSDT 4.119 26/06/2021,98.00849753066386,0.0,110.7971610837646
2021-06-26 11:03:00+00:00,symbol_transaction,SELL LONG 24.039738283002027 BINANCE-DEGOUSDT 4.144 26/06/2021,0.0,99.52,210.32
2021-06-26 12:51:00+00:00,symbol_transaction,SELL LONG 24.11811297448996 BINANCE-DEGOUSDT 4.138 26/06/2021,0.0,99.7,310.02
2021-06-26 13:21:00+00:00,symbol_transaction,SELL LONG 23.964318393748222 BINANCE-DEGOUSDT 4.158 26/06/2021,0.0,99.54,409.56
2021-06-26 13:33:00+00:00,symbol_transaction,BUY LONG 23.846221483995837 BINANCE-DEGOUSDT 4.092 26/06/2021,97.67631705082346,0.0,311.8868417845317
2021-06-26 13:35:00+00:00,symbol_transaction,SELL LONG 24.232396184797743 BINANCE-DEGOUSDT 4.087 26/06/2021,0.0,98.94,410.83
2021-06-26 14:27:00+00:00,symbol_transaction,BUY LONG 23.987876994931884 BINANCE-DEGOUSDT 4.03 26/06/2021,96.76781543386507,0.0,314.05779175472776
2021-06-26 14:42:00+00:00,symbol_transaction,SELL LONG 24.354445735308296 BINANCE-DEGOUSDT 4.074 26/06/2021,0.0,99.12,413.18
2021-06-26 14:55:00+00:00,symbol_transaction,SELL LONG 24.12590761023848 BINANCE-DEGOUSDT 4.117 26/06/2021,0.0,99.23,512.41
2021-06-26 15:00:00+00:00,symbol_transaction,BUY LONG 23.814942633648158 BINANCE-DEGOUSDT 4.112 26/06/2021,98.02497115367079,0.0,414.3806477844978
2021-06-26 15:01:00+00:00,symbol_transaction,SELL LONG 24.173707024460544 BINANCE-DEGOUSDT 4.107 26/06/2021,0.0,99.18,513.56
2021-06-26 15:12:00+00:00,symbol_transaction,SELL LONG 24.168913260480746 BINANCE-DEGOUSDT 4.127 26/06/2021,0.0,99.65,613.21
2021-06-26 17:57:00+00:00,symbol_transaction,SELL LONG 24.076534069894937 BINANCE-DEGOUSDT 4.112 26/06/2021,0.0,98.9,712.11
2021-06-26 18:58:00+00:00,symbol_transaction,SELL LONG 24.121940818088508 BINANCE-DEGOUSDT 4.104 26/06/2021,0.0,98.9,811.01
2021-06-26 19:03:00+00:00,symbol_transaction,SELL LONG 24.06492139214242 BINANCE-DEGOUSDT 4.129 26/06/2021,0.0,99.26,910.27
2021-06-27 00:51:00+00:00,symbol_transaction,SELL LONG 16.893260425176436 BINANCE-DEGOUSDT 4.16 27/06/2021,0.0,70.21,980.48
2021-06-27 02:17:00+00:00,symbol_transaction,BUY LONG 22.896217360781097 BINANCE-DEGOUSDT 4.278 27/06/2021,98.04796788729095,0.0,882.4317109856183
2021-06-27 02:25:00+00:00,symbol_transaction,BUY LONG 22.717233841416725 BINANCE-DEGOUSDT 4.315 27/06/2021,98.12288888973889,0.0,784.3088220958795
2021-06-27 02:34:00+00:00,symbol_transaction,SELL LONG 23.95351312641365 BINANCE-DEGOUSDT 4.325 27/06/2021,0.0,103.5,887.8
2021-06-27 03:04:00+00:00,symbol_transaction,SELL LONG 21.659938075784172 BINANCE-DEGOUSDT 4.339 27/06/2021,0.0,93.89,981.69
2021-06-27 04:03:00+00:00,symbol_transaction,BUY LONG 22.654468568226964 BINANCE-DEGOUSDT 4.329 27/06/2021,98.16926562628637,0.0,883.5233906365772
2021-06-27 05:04:00+00:00,symbol_transaction,BUY LONG 22.99705141772767 BINANCE-DEGOUSDT 4.259 27/06/2021,98.04238643009025,0.0,785.481004206487
2021-06-27 05:45:00+00:00,symbol_transaction,BUY LONG 23.270565367574267 BINANCE-DEGOUSDT 4.192 27/06/2021,97.6477602308922,0.0,687.8332439755948
2021-06-27 05:49:00+00:00,symbol_transaction,BUY LONG 23.336031803898408 BINANCE-DEGOUSDT 4.18 27/06/2021,97.64215755323563,0.0,590.1910864223591
2021-06-27 07:37:00+00:00,symbol_transaction,SELL LONG 24.033434612487884 BINANCE-DEGOUSDT 4.251 27/06/2021,0.0,102.06,692.26
2021-06-27 08:24:00+00:00,symbol_transaction,SELL LONG 23.94695955484856 BINANCE-DEGOUSDT 4.279 27/06/2021,0.0,102.37,794.62
2021-06-27 08:43:00+00:00,symbol_transaction,SELL LONG 23.941500178915565 BINANCE-DEGOUSDT 4.28 27/06/2021,0.0,102.37,896.99
2021-06-27 09:50:00+00:00,symbol_transaction,BUY LONG 23.713000808732755 BINANCE-DEGOUSDT 4.133 27/06/2021,98.10383817483496,0.0,798.8849346949271
2021-06-27 11:13:00+00:00,symbol_transaction,SELL LONG 24.021556647134137 BINANCE-DEGOUSDT 4.206 27/06/2021,0.0,100.93,899.82
2021-06-27 11:58:00+00:00,symbol_transaction,SELL LONG 20.02766697277393 BINANCE-DEGOUSDT 4.261 27/06/2021,0.0,85.25,985.07
2021-06-27 12:02:00+00:00,symbol_transaction,BUY LONG 23.111485000850124 BINANCE-DEGOUSDT 4.261 27/06/2021,98.576515626211,0.0,886.4946027413232
2021-06-27 12:15:00+00:00,symbol_transaction,BUY LONG 23.20077157237495 BINANCE-DEGOUSDT 4.239 27/06/2021,98.4464187659927,0.0,788.0481839753305
2021-06-27 12:32:00+00:00,symbol_transaction,SELL LONG 23.934804418215702 BINANCE-DEGOUSDT 4.277 27/06/2021,0.0,102.27,890.31
2021-06-27 14:05:00+00:00,symbol_transaction,BUY LONG 23.277041472196295 BINANCE-DEGOUSDT 4.234 27/06/2021,98.65354858687239,0.0,791.66142472667
2021-06-27 14:15:00+00:00,symbol_transaction,BUY LONG 23.359808231139542 BINANCE-DEGOUSDT 4.207 27/06/2021,98.37298794163246,0.0,693.2884367850376
2021-06-27 14:35:00+00:00,symbol_transaction,SELL LONG 23.945148789877237 BINANCE-DEGOUSDT 4.256 27/06/2021,0.0,101.81,795.1
2021-06-27 14:42:00+00:00,symbol_transaction,SELL LONG 23.958892137257145 BINANCE-DEGOUSDT 4.25 27/06/2021,0.0,101.72,896.82
2021-06-27 15:50:00+00:00,symbol_transaction,SELL LONG 21.11026093121083 BINANCE-DEGOUSDT 4.308 27/06/2021,0.0,90.85,987.67
2021-06-27 16:34:00+00:00,symbol_transaction,BUY LONG 23.15620560760126 BINANCE-DEGOUSDT 4.261 27/06/2021,98.76726068608296,0.0,888.9053461747466
2021-06-28 00:03:00+00:00,symbol_transaction,BUY LONG 22.250831475462185 BINANCE-DEGOUSDT 4.487 28/06/2021,99.93932031122922,0.0,788.9660258635173
2021-06-28 00:29:00+00:00,symbol_transaction,SELL LONG 23.651171057626563 BINANCE-DEGOUSDT 4.517 28/06/2021,0.0,106.73,895.69
2021-06-28 03:32:00+00:00,symbol_transaction,BUY LONG 22.55602677602164 BINANCE-DEGOUSDT 4.4 28/06/2021,99.34576433230971,0.0,796.3457688588395
2021-06-28 03:42:00+00:00,symbol_transaction,BUY LONG 22.561027816014356 BINANCE-DEGOUSDT 4.385 28/06/2021,99.02903708019618,0.0,697.3167317786433
2021-06-28 04:55:00+00:00,symbol_transaction,BUY LONG 22.54895112380443 BINANCE-DEGOUSDT 4.4 28/06/2021,99.31460032968424,0.0,598.0021314489591
2021-06-28 05:39:00+00:00,symbol_transaction,SELL LONG 23.55609051766324 BINANCE-DEGOUSDT 4.489 28/06/2021,0.0,105.64,703.64
2021-06-28 05:41:00+00:00,symbol_transaction,SELL LONG 23.622591624748885 BINANCE-DEGOUSDT 4.475 28/06/2021,0.0,105.61,809.25
2021-06-28 06:28:00+00:00,symbol_transaction,SELL LONG 23.43891983407755 BINANCE-DEGOUSDT 4.583 28/06/2021,0.0,107.31,916.56
2021-06-28 07:39:00+00:00,symbol_transaction,SELL LONG 18.804269764787634 BINANCE-DEGOUSDT 4.611 28/06/2021,0.0,86.62,1003.18
2021-06-28 08:05:00+00:00,symbol_transaction,BUY LONG 21.635920110614226 BINANCE-DEGOUSDT 4.614 28/06/2021,99.9279635257644,0.0,903.2500318174098
2021-06-28 08:11:00+00:00,symbol_transaction,SELL LONG 21.635920110614226 BINANCE-DEGOUSDT 4.609 28/06/2021,0.0,99.62,1002.87
2021-06-28 08:21:00+00:00,symbol_transaction,BUY LONG 21.462476419284254 BINANCE-DEGOUSDT 4.652 28/06/2021,99.94328374281287,0.0,902.926983908628
2021-06-28 08:24:00+00:00,symbol_transaction,BUY LONG 21.61787208220866 BINANCE-DEGOUSDT 4.637 28/06/2021,100.34231491804675,0.0,802.5846689905812
2021-06-28 08:28:00+00:00,symbol_transaction,BUY LONG 21.65833904336959 BINANCE-DEGOUSDT 4.602 28/06/2021,99.77134795386443,0.0,702.8133210367168
2021-06-28 08:44:00+00:00,symbol_transaction,SELL LONG 23.485030861442343 BINANCE-DEGOUSDT 4.61 28/06/2021,0.0,108.16,810.97
2021-06-28 08:47:00+00:00,symbol_transaction,SELL LONG 23.441942175025332 BINANCE-DEGOUSDT 4.633 28/06/2021,0.0,108.5,919.47
2021-06-28 09:22:00+00:00,symbol_transaction,SELL LONG 17.81171450839483 BINANCE-DEGOUSDT 4.541 28/06/2021,0.0,80.8,1000.27
2021-06-28 09:41:00+00:00,symbol_transaction,BUY LONG 22.127364917667112 BINANCE-DEGOUSDT 4.529 28/06/2021,100.31505054782646,0.0,899.9560209337021
2021-06-28 09:50:00+00:00,symbol_transaction,BUY LONG 22.211793239877274 BINANCE-DEGOUSDT 4.473 28/06/2021,99.45270451313301,0.0,800.5033164205691
2021-06-28 10:16:00+00:00,symbol_transaction,SELL LONG 23.65398037265591 BINANCE-DEGOUSDT 4.449 28/06/2021,0.0,105.13,905.63
2021-06-28 11:02:00+00:00,symbol_transaction,SELL LONG 20.68517778488848 BINANCE-DEGOUSDT 4.422 28/06/2021,0.0,91.38,997.01
2021-06-28 16:07:00+00:00,symbol_transaction,BUY LONG 21.55414429432177 BINANCE-DEGOUSDT 4.628 28/06/2021,99.85233237391527,0.0,897.1606924745342
2021-06-28 16:40:00+00:00,symbol_transaction,SELL LONG 21.55414429432177 BINANCE-DEGOUSDT 4.561 28/06/2021,0.0,98.21,995.37
2021-06-28 17:49:00+00:00,symbol_transaction,BUY LONG 22.072729404863942 BINANCE-DEGOUSDT 4.517 28/06/2021,99.8022212404922,0.0,895.5686149083172
2021-06-28 18:02:00+00:00,symbol_transaction,SELL LONG 22.072729404863942 BINANCE-DEGOUSDT 4.525 28/06/2021,0.0,99.78,995.35
2021-06-29 02:30:00+00:00,symbol_transaction,BUY LONG 21.621080297497016 BINANCE-DEGOUSDT 4.585 29/06/2021,99.23178581718784,0.0,896.1160505475816
2021-06-29 05:35:00+00:00,symbol_transaction,BUY LONG 22.018440311434315 BINANCE-DEGOUSDT 4.511 29/06/2021,99.42450942912507,0.0,796.6915411184566
2021-06-29 06:19:00+00:00,symbol_transaction,BUY LONG 21.805792500712826 BINANCE-DEGOUSDT 4.562 29/06/2021,99.57750341364017,0.0,697.1140377048164
2021-06-29 06:42:00+00:00,symbol_transaction,SELL LONG 23.615857189781412 BINANCE-DEGOUSDT 4.605 29/06/2021,0.0,108.64,805.76
2021-06-29 06:50:00+00:00,symbol_transaction,SELL LONG 23.564400678811598 BINANCE-DEGOUSDT 4.64 29/06/2021,0.0,109.23,914.99
2021-06-29 07:02:00+00:00,symbol_transaction,SELL LONG 18.26505524105115 BINANCE-DEGOUSDT 4.631 29/06/2021,0.0,84.5,999.49
2021-06-29 07:22:00+00:00,symbol_transaction,BUY LONG 21.55165522417198 BINANCE-DEGOUSDT 4.634 29/06/2021,99.97024067912177,0.0,899.5164340433018
2021-06-29 07:24:00+00:00,symbol_transaction,BUY LONG 21.59519806220229 BINANCE-DEGOUSDT 4.634 29/06/2021,100.17221996806566,0.0,799.3442140752362
2021-06-29 07:30:00+00:00,symbol_transaction,SELL LONG 23.546333651108494 BINANCE-DEGOUSDT 4.643 29/06/2021,0.0,109.22,908.56
2021-06-29 07:45:00+00:00,symbol_transaction,BUY LONG 21.836605974945215 BINANCE-DEGOUSDT 4.585 29/06/2021,100.22095923351894,0.0,808.3395563566719
2021-06-29 08:05:00+00:00,symbol_transaction,BUY LONG 21.88752956676581 BINANCE-DEGOUSDT 4.555 29/06/2021,99.79739487379489,0.0,708.542161482877
2021-06-29 08:35:00+00:00,symbol_transaction,SELL LONG 23.645241525722934 BINANCE-DEGOUSDT 4.58 29/06/2021,0.0,108.19,816.73
2021-06-29 08:36:00+00:00,symbol_transaction,SELL LONG 23.672074362215568 BINANCE-DEGOUSDT 4.591 29/06/2021,0.0,108.57,925.3
2021-06-29 08:37:00+00:00,symbol_transaction,SELL LONG 16.007339289038285 BINANCE-DEGOUSDT 4.592 29/06/2021,0.0,73.43,998.73
2021-06-29 15:09:00+00:00,symbol_transaction,BUY LONG 21.21031782166141 BINANCE-DEGOUSDT 4.71 29/06/2021,100.00049753696527,0.0,898.7305861443181
2021-06-29 15:16:00+00:00,symbol_transaction,SELL LONG 21.21031782166141 BINANCE-DEGOUSDT 4.709 29/06/2021,0.0,99.78,998.51
2021-06-30 00:29:00+00:00,symbol_transaction,BUY LONG 21.156152296905635 BINANCE-DEGOUSDT 4.721 30/06/2021,99.9780731886852,0.0,898.5320201912142
2021-06-30 03:08:00+00:00,symbol_transaction,BUY LONG 21.584963459099452 BINANCE-DEGOUSDT 4.61 30/06/2021,99.60618822799492,0.0,798.9258319632193
2021-06-30 03:30:00+00:00,symbol_transaction,BUY LONG 21.826544423241046 BINANCE-DEGOUSDT 4.545 30/06/2021,99.30084604803419,0.0,699.6249859151851
2021-06-30 03:57:00+00:00,symbol_transaction,BUY LONG 21.94413214769634 BINANCE-DEGOUSDT 4.511 30/06/2021,99.08897009837645,0.0,600.5360158168087
2021-06-30 04:10:00+00:00,symbol_transaction,BUY LONG 21.97148758995674 BINANCE-DEGOUSDT 4.501 30/06/2021,98.9925593080377,0.0,501.543456508771
2021-06-30 04:43:00+00:00,symbol_transaction,BUY LONG 22.006514444449465 BINANCE-DEGOUSDT 4.471 30/06/2021,98.4895172072147,0.0,403.0539393015563
2021-06-30 05:07:00+00:00,symbol_transaction,BUY LONG 22.011674389065387 BINANCE-DEGOUSDT 4.482 30/06/2021,98.75498093640286,0.0,304.29895836515345
2021-06-30 05:24:00+00:00,symbol_transaction,BUY LONG 22.087819163298164 BINANCE-DEGOUSDT 4.436 30/06/2021,98.07954737419905,0.0,206.2194109909544
2021-06-30 05:31:00+00:00,symbol_transaction,SELL LONG 24.11866637003209 BINANCE-DEGOUSDT 4.462 30/06/2021,0.0,107.51,313.73
2021-06-30 06:07:00+00:00,symbol_transaction,SELL LONG 23.984612445386315 BINANCE-DEGOUSDT 4.487 30/06/2021,0.0,107.51,421.24
2021-06-30 06:34:00+00:00,symbol_transaction,SELL LONG 23.861879456663956 BINANCE-DEGOUSDT 4.523 30/06/2021,0.0,107.82,529.06
2021-06-30 09:04:00+00:00,symbol_transaction,SELL LONG 24.188441309496213 BINANCE-DEGOUSDT 4.401 30/06/2021,0.0,106.35,635.41
2021-06-30 10:10:00+00:00,symbol_transaction,SELL LONG 24.163685336530683 BINANCE-DEGOUSDT 4.405 30/06/2021,0.0,106.33,741.74
2021-06-30 11:03:00+00:00,symbol_transaction,BUY LONG 21.91043990814368 BINANCE-DEGOUSDT 4.489 30/06/2021,98.45432071240462,0.0,643.2871224668044
2021-06-30 11:04:00+00:00,symbol_transaction,BUY LONG 21.92661668164144 BINANCE-DEGOUSDT 4.467 30/06/2021,98.0441429136092,0.0,545.2429795531951
2021-06-30 11:05:00+00:00,symbol_transaction,BUY LONG 21.994932506963014 BINANCE-DEGOUSDT 4.509 30/06/2021,99.27432582457014,0.0,445.968653728625
2021-06-30 11:06:00+00:00,symbol_transaction,SELL LONG 24.101201500686315 BINANCE-DEGOUSDT 4.509 30/06/2021,0.0,108.56,554.53
2021-06-30 13:05:00+00:00,symbol_transaction,BUY LONG 22.172526223555074 BINANCE-DEGOUSDT 4.401 30/06/2021,97.67886919777574,0.0,456.8534297798773
2021-06-30 13:17:00+00:00,symbol_transaction,BUY LONG 22.185462884088828 BINANCE-DEGOUSDT 4.388 30/06/2021,97.44716094651716,0.0,359.4062688333601
2021-06-30 14:40:00+00:00,symbol_transaction,BUY LONG 22.281711345619073 BINANCE-DEGOUSDT 4.343 30/06/2021,96.86624184639766,0.0,262.54002698696246
2021-06-30 15:09:00+00:00,symbol_transaction,BUY LONG 22.38315313234202 BINANCE-DEGOUSDT 4.317 30/06/2021,96.72470014439283,0.0,165.81532684256962
2021-06-30 15:20:00+00:00,symbol_transaction,BUY LONG 22.352592181513934 BINANCE-DEGOUSDT 4.284 30/06/2021,95.8542634105113,0.0,69.96106343205832
2021-06-30 15:37:00+00:00,symbol_transaction,BUY LONG 3.8819992933142657 BINANCE-DEGOUSDT 4.27 30/06/2021,16.592713119434364,0.0,53.36835031262396
2021-06-30 19:02:00+00:00,symbol_transaction,SELL LONG 24.033473650695218 BINANCE-DEGOUSDT 4.412 30/06/2021,0.0,105.93,159.3
2021-06-30 19:49:00+00:00,symbol_transaction,SELL LONG 23.85948990475239 BINANCE-DEGOUSDT 4.459 30/06/2021,0.0,106.28,265.58
2021-07-01 00:58:00+00:00,symbol_transaction,SELL LONG 23.147748933542246 BINANCE-DEGOUSDT 4.629 01/07/2021,0.0,107.04,372.62
2021-07-01 01:53:00+00:00,symbol_transaction,SELL LONG 23.015913686766094 BINANCE-DEGOUSDT 4.685 01/07/2021,0.0,107.72,480.35
2021-07-01 02:16:00+00:00,symbol_transaction,BUY LONG 22.13600376490322 BINANCE-DEGOUSDT 4.6 01/07/2021,101.92744293587334,0.0,378.419138408107
2021-07-01 02:43:00+00:00,symbol_transaction,BUY LONG 22.28933721622217 BINANCE-DEGOUSDT 4.549 01/07/2021,101.49558919159125,0.0,276.92354921651577
2021-07-01 03:38:00+00:00,symbol_transaction,BUY LONG 22.267254985816596 BINANCE-DEGOUSDT 4.52 01/07/2021,100.7486405284269,0.0,176.17490868808886
2021-07-01 04:08:00+00:00,symbol_transaction,SELL LONG 23.130090035595202 BINANCE-DEGOUSDT 4.624 01/07/2021,0.0,106.85,283.02
2021-07-01 04:09:00+00:00,symbol_transaction,SELL LONG 23.11315761194999 BINANCE-DEGOUSDT 4.625 01/07/2021,0.0,106.79,389.81
2021-07-01 04:15:00+00:00,symbol_transaction,SELL LONG 23.05992736068615 BINANCE-DEGOUSDT 4.633 01/07/2021,0.0,106.73,496.54
2021-07-01 04:19:00+00:00,symbol_transaction,BUY LONG 22.147741020695676 BINANCE-DEGOUSDT 4.639 01/07/2021,102.84611396560226,0.0,393.69663993066445
2021-07-01 04:36:00+00:00,symbol_transaction,BUY LONG 22.32539440221172 BINANCE-DEGOUSDT 4.553 01/07/2021,101.74916823398324,0.0,291.9474716966812
2021-07-01 06:13:00+00:00,symbol_transaction,SELL LONG 23.337109753485382 BINANCE-DEGOUSDT 4.578 01/07/2021,0.0,106.73,398.68
2021-07-01 06:35:00+00:00,symbol_transaction,SELL LONG 23.211656917007694 BINANCE-DEGOUSDT 4.634 01/07/2021,0.0,107.46,506.13
2021-07-01 06:36:00+00:00,symbol_transaction,SELL LONG 23.10498588304377 BINANCE-DEGOUSDT 4.651 01/07/2021,0.0,107.35,613.49
2021-07-01 06:37:00+00:00,symbol_transaction,SELL LONG 23.056871498675633 BINANCE-DEGOUSDT 4.641 01/07/2021,0.0,106.9,720.39
2021-07-01 06:48:00+00:00,symbol_transaction,BUY LONG 22.519127786997718 BINANCE-DEGOUSDT 4.484 01/07/2021,101.07674476589467,0.0,619.3101951664742
2021-07-01 06:55:00+00:00,symbol_transaction,SELL LONG 23.33410351426105 BINANCE-DEGOUSDT 4.513 01/07/2021,0.0,105.2,724.51
2021-07-01 06:59:00+00:00,symbol_transaction,BUY LONG 22.797798941757467 BINANCE-DEGOUSDT 4.458 01/07/2021,101.73422027003716,0.0,622.7774772471373
2021-07-01 07:56:00+00:00,symbol_transaction,SELL LONG 23.659246768524024 BINANCE-DEGOUSDT 4.37 01/07/2021,0.0,103.29,726.06
2021-07-01 08:12:00+00:00,symbol_transaction,BUY LONG 23.15895624639335 BINANCE-DEGOUSDT 4.344 01/07/2021,100.70310844026704,0.0,625.3618862769417
2021-07-01 09:15:00+00:00,symbol_transaction,BUY LONG 23.189825890578156 BINANCE-DEGOUSDT 4.334 01/07/2021,100.60521011517548,0.0,524.7566761617662
2021-07-01 09:53:00+00:00,symbol_transaction,SELL LONG 23.962985876031293 BINANCE-DEGOUSDT 4.297 01/07/2021,0.0,102.87,627.62
2021-07-01 10:02:00+00:00,symbol_transaction,SELL LONG 23.93433470705531 BINANCE-DEGOUSDT 4.291 01/07/2021,0.0,102.6,730.22
2021-07-01 10:27:00+00:00,symbol_transaction,BUY LONG 23.406908116946585 BINANCE-DEGOUSDT 4.276 01/07/2021,100.18802704717166,0.0,630.0341584713381
2021-07-01 11:16:00+00:00,symbol_transaction,SELL LONG 23.775844613402356 BINANCE-DEGOUSDT 4.352 01/07/2021,0.0,103.37,733.4
2021-07-01 11:17:00+00:00,symbol_transaction,SELL LONG 23.768242842025934 BINANCE-DEGOUSDT 4.349 01/07/2021,0.0,103.26,836.67
2021-07-01 13:20:00+00:00,symbol_transaction,SELL LONG 23.654389893032498 BINANCE-DEGOUSDT 4.431 01/07/2021,0.0,104.71,941.38
2021-07-01 13:24:00+00:00,symbol_transaction,SELL LONG 15.33901057408832 BINANCE-DEGOUSDT 4.433 01/07/2021,0.0,67.93,1009.31
2021-07-01 13:49:00+00:00,symbol_transaction,BUY LONG 22.863882304553233 BINANCE-DEGOUSDT 4.41 01/07/2021,100.93055068404284,0.0,908.3749561563852
2021-07-01 15:22:00+00:00,symbol_transaction,BUY LONG 23.01200473545914 BINANCE-DEGOUSDT 4.398 01/07/2021,101.30800362337584,0.0,807.0669525330094
2021-07-01 17:00:00+00:00,symbol_transaction,BUY LONG 23.19474835391624 BINANCE-DEGOUSDT 4.332 01/07/2021,100.58012951903432,0.0,706.486823013975
2021-07-01 17:54:00+00:00,symbol_transaction,SELL LONG 23.55226122848874 BINANCE-DEGOUSDT 4.45 01/07/2021,0.0,104.7,811.19
2021-07-01 18:29:00+00:00,symbol_transaction,SELL LONG 23.60465331253195 BINANCE-DEGOUSDT 4.42 01/07/2021,0.0,104.23,915.42
2021-07-01 19:02:00+00:00,symbol_transaction,BUY LONG 23.13520465416007 BINANCE-DEGOUSDT 4.372 01/07/2021,101.24826186273582,0.0,814.1695511292971
2021-07-02 00:11:00+00:00,symbol_transaction,SELL LONG 23.57974486743764 BINANCE-DEGOUSDT 4.424 02/07/2021,0.0,104.21,918.38
2021-07-02 01:34:00+00:00,symbol_transaction,SELL LONG 21.469180639630338 BINANCE-DEGOUSDT 4.342 02/07/2021,0.0,93.13,1011.51
2021-07-02 01:56:00+00:00,symbol_transaction,BUY LONG 23.538259755303756 BINANCE-DEGOUSDT 4.299 02/07/2021,101.2921696667389,0.0,910.2158191197465
2021-07-02 03:15:00+00:00,symbol_transaction,BUY LONG 23.721780320233563 BINANCE-DEGOUSDT 4.263 02/07/2021,101.22707545466083,0.0,808.9887436650856
2021-07-02 03:27:00+00:00,symbol_transaction,BUY LONG 23.732822670770656 BINANCE-DEGOUSDT 4.211 02/07/2021,100.03885518288185,0.0,708.9498884822037
2021-07-02 03:28:00+00:00,symbol_transaction,BUY LONG 23.91104107260364 BINANCE-DEGOUSDT 4.21 02/07/2021,100.76614839857699,0.0,608.1837400836267
2021-07-02 03:37:00+00:00,symbol_transaction,BUY LONG 23.861410393595243 BINANCE-DEGOUSDT 4.222 02/07/2021,100.84361755644088,0.0,507.3401225271858
2021-07-02 04:21:00+00:00,symbol_transaction,SELL LONG 23.824374659311065 BINANCE-DEGOUSDT 4.239 02/07/2021,0.0,100.89,608.23
2021-07-02 05:50:00+00:00,symbol_transaction,BUY LONG 24.08391333808493 BINANCE-DEGOUSDT 4.158 02/07/2021,100.24105257141692,0.0,507.98960261240774
2021-07-02 06:20:00+00:00,symbol_transaction,BUY LONG 24.142698038033732 BINANCE-DEGOUSDT 4.142 02/07/2021,100.09905432880927,0.0,407.8905482835985
2021-07-02 06:24:00+00:00,symbol_transaction,BUY LONG 24.1379116124944 BINANCE-DEGOUSDT 4.152 02/07/2021,100.32082962409183,0.0,307.56971865950663
2021-07-02 08:17:00+00:00,symbol_transaction,SELL LONG 23.659211302043516 BINANCE-DEGOUSDT 4.256 02/07/2021,0.0,100.59,408.16
2021-07-02 08:50:00+00:00,symbol_transaction,SELL LONG 23.834247909937602 BINANCE-DEGOUSDT 4.19 02/07/2021,0.0,99.77,507.93
2021-07-02 09:04:00+00:00,symbol_transaction,SELL LONG 23.914712888704678 BINANCE-DEGOUSDT 4.195 02/07/2021,0.0,100.22,608.15
2021-07-02 10:42:00+00:00,symbol_transaction,SELL LONG 24.09842365680307 BINANCE-DEGOUSDT 4.141 02/07/2021,0.0,99.69,707.84
2021-07-02 11:15:00+00:00,symbol_transaction,SELL LONG 23.96363167283457 BINANCE-DEGOUSDT 4.174 02/07/2021,0.0,99.92,807.77
2021-07-02 12:32:00+00:00,symbol_transaction,SELL LONG 24.01444884041705 BINANCE-DEGOUSDT 4.152 02/07/2021,0.0,99.61,907.37
2021-07-02 12:48:00+00:00,symbol_transaction,SELL LONG 23.820786271068357 BINANCE-DEGOUSDT 4.194 02/07/2021,0.0,99.8,1007.18
