timestamp,type,description,debit,credit,balance
2021-07-03 18:18:39.453447+00:00,symbol_transaction,BUY LONG 234.19940899310745 KUCOIN-DEGOUSDT 0 03/07/2021,0.0,0.0,0.0
2021-06-26 00:36:00+00:00,symbol_transaction,SELL LONG 22.93917334101031 KUCOIN-DEGOUSDT 4.3729 26/06/2021,0.0,100.21,100.21
2021-06-26 01:13:00+00:00,symbol_transaction,SELL LONG 23.18745460256113 KUCOIN-DEGOUSDT 4.3375 26/06/2021,0.0,100.48,200.69
2021-06-26 01:39:00+00:00,symbol_transaction,SELL LONG 23.39553782021668 KUCOIN-DEGOUSDT 4.2833 26/06/2021,0.0,100.11,300.8
2021-06-26 02:26:00+00:00,symbol_transaction,SELL LONG 23.488683267189504 KUCOIN-DEGOUSDT 4.2439 26/06/2021,0.0,99.58,400.38
2021-06-26 02:27:00+00:00,symbol_transaction,SELL LONG 23.606931010763706 KUCOIN-DEGOUSDT 4.2086 26/06/2021,0.0,99.25,499.63
2021-06-26 02:30:00+00:00,symbol_transaction,SELL LONG 23.75693340676556 KUCOIN-DEGOUSDT 4.1837 26/06/2021,0.0,99.29,598.92
2021-06-26 02:59:00+00:00,symbol_transaction,SELL LONG 23.675642834153617 KUCOIN-DEGOUSDT 4.2241 26/06/2021,0.0,99.91,698.83
2021-06-26 03:01:00+00:00,symbol_transaction,SELL LONG 23.687542084868166 KUCOIN-DEGOUSDT 4.2261 26/06/2021,0.0,100.01,798.84
2021-06-26 03:03:00+00:00,symbol_transaction,SELL LONG 23.661777488651232 KUCOIN-DEGOUSDT 4.2009 26/06/2021,0.0,99.3,898.14
2021-06-26 03:22:00+00:00,symbol_transaction,SELL LONG 22.799733136927557 KUCOIN-DEGOUSDT 4.1766 26/06/2021,0.0,95.13,993.27
2021-06-26 05:04:00+00:00,symbol_transaction,BUY LONG 23.47975264256842 KUCOIN-DEGOUSDT 4.2261 26/06/2021,99.32701042540116,0.0,893.9430938286102
2021-06-26 05:36:00+00:00,symbol_transaction,SELL LONG 23.47975264256842 KUCOIN-DEGOUSDT 4.2241 26/06/2021,0.0,99.08,993.02
2021-06-26 10:42:00+00:00,symbol_transaction,BUY LONG 24.345555694500508 KUCOIN-DEGOUSDT 4.0748 26/06/2021,99.30247361429461,0.0,893.7222625286514
2021-06-26 10:57:00+00:00,symbol_transaction,SELL LONG 23.770475101655776 KUCOIN-DEGOUSDT 4.1158 26/06/2021,0.0,97.74,991.46
2021-06-26 11:03:00+00:00,symbol_transaction,BUY LONG 24.039738283002027 KUCOIN-DEGOUSDT 4.1516 26/06/2021,99.90318083316693,0.0,891.5557685974559
2021-06-26 12:51:00+00:00,symbol_transaction,BUY LONG 24.11811297448996 KUCOIN-DEGOUSDT 4.1122 26/06/2021,99.2776826778713,0.0,792.2780859195846
2021-06-26 13:21:00+00:00,symbol_transaction,BUY LONG 23.964318393748222 KUCOIN-DEGOUSDT 4.1448 26/06/2021,99.42663418528603,0.0,692.8514517342985
2021-06-26 13:33:00+00:00,symbol_transaction,SELL LONG 23.846221483995837 KUCOIN-DEGOUSDT 4.1069 26/06/2021,0.0,97.84,790.69
2021-06-26 13:35:00+00:00,symbol_transaction,BUY LONG 24.232396184797743 KUCOIN-DEGOUSDT 4.0817 26/06/2021,99.00828087899643,0.0,691.679283820912
2021-06-26 14:27:00+00:00,symbol_transaction,SELL LONG 23.987876994931884 KUCOIN-DEGOUSDT 4.0169 26/06/2021,0.0,96.26,787.94
2021-06-26 14:42:00+00:00,symbol_transaction,BUY LONG 24.354445735308296 KUCOIN-DEGOUSDT 4.063 26/06/2021,99.05106513558016,0.0,688.8887648831727
2021-06-26 14:55:00+00:00,symbol_transaction,BUY LONG 24.12590761023848 KUCOIN-DEGOUSDT 4.1152 26/06/2021,99.38221793265106,0.0,589.5065469505216
2021-06-26 15:00:00+00:00,symbol_transaction,SELL LONG 23.814942633648158 KUCOIN-DEGOUSDT 4.0817 26/06/2021,0.0,97.11,686.61
2021-06-26 15:01:00+00:00,symbol_transaction,BUY LONG 24.173707024460544 KUCOIN-DEGOUSDT 4.1119 26/06/2021,99.4992657797932,0.0,587.1155270671424
2021-06-26 15:12:00+00:00,symbol_transaction,BUY LONG 24.168913260480746 KUCOIN-DEGOUSDT 4.1121 26/06/2021,99.4843732066413,0.0,487.63115386050106
2021-06-26 17:57:00+00:00,symbol_transaction,BUY LONG 24.076534069894937 KUCOIN-DEGOUSDT 4.1011 26/06/2021,98.83901414792017,0.0,388.7921397125809
2021-06-26 18:58:00+00:00,symbol_transaction,BUY LONG 24.121940818088508 KUCOIN-DEGOUSDT 4.0805 26/06/2021,98.52800908771836,0.0,290.2641306248625
2021-06-26 19:03:00+00:00,symbol_transaction,BUY LONG 24.06492139214242 KUCOIN-DEGOUSDT 4.1121 26/06/2021,99.05632061988547,0.0,191.20781000497703
2021-06-27 00:51:00+00:00,symbol_transaction,BUY LONG 16.893260425176436 KUCOIN-DEGOUSDT 4.1386 27/06/2021,69.98436204323085,0.0,121.22344796174619
2021-06-27 02:17:00+00:00,symbol_transaction,SELL LONG 22.896217360781097 KUCOIN-DEGOUSDT 4.2974 27/06/2021,0.0,98.3,219.52
2021-06-27 02:25:00+00:00,symbol_transaction,SELL LONG 22.717233841416725 KUCOIN-DEGOUSDT 4.3375 27/06/2021,0.0,98.44,317.96
2021-06-27 02:34:00+00:00,symbol_transaction,BUY LONG 23.95351312641365 KUCOIN-DEGOUSDT 4.2893 27/06/2021,102.8465476569792,0.0,215.11017637185935
2021-06-27 03:04:00+00:00,symbol_transaction,BUY LONG 21.659938075784172 KUCOIN-DEGOUSDT 4.3197 27/06/2021,93.65799894047086,0.0,121.45217743138849
2021-06-27 04:03:00+00:00,symbol_transaction,SELL LONG 22.654468568226964 KUCOIN-DEGOUSDT 4.3576 27/06/2021,0.0,98.62,220.07
2021-06-27 05:04:00+00:00,symbol_transaction,SELL LONG 22.99705141772767 KUCOIN-DEGOUSDT 4.275 27/06/2021,0.0,98.21,318.29
2021-06-27 05:45:00+00:00,symbol_transaction,SELL LONG 23.270565367574267 KUCOIN-DEGOUSDT 4.203 27/06/2021,0.0,97.71,416.0
2021-06-27 05:49:00+00:00,symbol_transaction,SELL LONG 23.336031803898408 KUCOIN-DEGOUSDT 4.1944 27/06/2021,0.0,97.78,513.78
2021-06-27 07:37:00+00:00,symbol_transaction,BUY LONG 24.033434612487884 KUCOIN-DEGOUSDT 4.2349 27/06/2021,101.88097143266536,0.0,411.8968327355189
2021-06-27 08:24:00+00:00,symbol_transaction,BUY LONG 23.94695955484856 KUCOIN-DEGOUSDT 4.2607 27/06/2021,102.13284138591861,0.0,309.7639913496003
2021-06-27 08:43:00+00:00,symbol_transaction,BUY LONG 23.941500178915565 KUCOIN-DEGOUSDT 4.2625 27/06/2021,102.15269515714023,0.0,207.6112961924601
2021-06-27 09:50:00+00:00,symbol_transaction,SELL LONG 23.713000808732755 KUCOIN-DEGOUSDT 4.1472 27/06/2021,0.0,98.24,305.86
2021-06-27 11:13:00+00:00,symbol_transaction,BUY LONG 24.021556647134137 KUCOIN-DEGOUSDT 4.1758 27/06/2021,100.40952546334982,0.0,205.44598512613277
2021-06-27 11:58:00+00:00,symbol_transaction,BUY LONG 20.02766697277393 KUCOIN-DEGOUSDT 4.2541 27/06/2021,85.28489776694646,0.0,120.16108735918631
2021-06-27 12:02:00+00:00,symbol_transaction,SELL LONG 23.111485000850124 KUCOIN-DEGOUSDT 4.2773 27/06/2021,0.0,98.76,218.92
2021-06-27 12:15:00+00:00,symbol_transaction,SELL LONG 23.20077157237495 KUCOIN-DEGOUSDT 4.2647 27/06/2021,0.0,98.85,317.76
2021-06-27 12:32:00+00:00,symbol_transaction,BUY LONG 23.934804418215702 KUCOIN-DEGOUSDT 4.2573 27/06/2021,101.99954049251937,0.0,215.7628331001918
2021-06-27 14:05:00+00:00,symbol_transaction,SELL LONG 23.277041472196295 KUCOIN-DEGOUSDT 4.25 27/06/2021,0.0,98.83,314.59
2021-06-27 14:15:00+00:00,symbol_transaction,SELL LONG 23.359808231139542 KUCOIN-DEGOUSDT 4.2241 27/06/2021,0.0,98.58,413.17
2021-06-27 14:35:00+00:00,symbol_transaction,BUY LONG 23.945148789877237 KUCOIN-DEGOUSDT 4.24 27/06/2021,101.62895829994858,0.0,311.53786541402803
2021-06-27 14:42:00+00:00,symbol_transaction,BUY LONG 23.958892137257145 KUCOIN-DEGOUSDT 4.2307 27/06/2021,101.4642478500589,0.0,210.07361756396915
2021-06-27 15:50:00+00:00,symbol_transaction,BUY LONG 21.11026093121083 KUCOIN-DEGOUSDT 4.3076 27/06/2021,91.02549454727107,0.0,119.04812301669809
2021-06-27 16:34:00+00:00,symbol_transaction,SELL LONG 23.15620560760126 KUCOIN-DEGOUSDT 4.2518 27/06/2021,0.0,98.36,217.41
2021-06-28 00:03:00+00:00,symbol_transaction,SELL LONG 22.250831475462185 KUCOIN-DEGOUSDT 4.4875 28/06/2021,0.0,99.75,317.16
2021-06-28 00:29:00+00:00,symbol_transaction,BUY LONG 23.651171057626563 KUCOIN-DEGOUSDT 4.5019 28/06/2021,106.58168219131335,0.0,210.5742959126718
2021-06-28 03:32:00+00:00,symbol_transaction,SELL LONG 22.55602677602164 KUCOIN-DEGOUSDT 4.4377 28/06/2021,0.0,100.0,310.57
2021-06-28 03:42:00+00:00,symbol_transaction,SELL LONG 22.561027816014356 KUCOIN-DEGOUSDT 4.4074 28/06/2021,0.0,99.34,409.91
2021-06-28 04:55:00+00:00,symbol_transaction,SELL LONG 22.54895112380443 KUCOIN-DEGOUSDT 4.4336 28/06/2021,0.0,99.87,509.78
2021-06-28 05:39:00+00:00,symbol_transaction,BUY LONG 23.55609051766324 KUCOIN-DEGOUSDT 4.4755 28/06/2021,105.53070839491363,0.0,404.24946585678765
2021-06-28 05:41:00+00:00,symbol_transaction,BUY LONG 23.622591624748885 KUCOIN-DEGOUSDT 4.439 28/06/2021,104.96554490648256,0.0,299.28392095030506
2021-06-28 06:28:00+00:00,symbol_transaction,BUY LONG 23.43891983407755 KUCOIN-DEGOUSDT 4.5726 28/06/2021,107.28398163813631,0.0,191.99993931216875
2021-06-28 07:39:00+00:00,symbol_transaction,BUY LONG 18.804269764787634 KUCOIN-DEGOUSDT 4.5828 28/06/2021,86.26238368554684,0.0,105.73755562662191
2021-06-28 08:05:00+00:00,symbol_transaction,SELL LONG 21.635920110614226 KUCOIN-DEGOUSDT 4.6548 28/06/2021,0.0,100.61,206.35
2021-06-28 08:11:00+00:00,symbol_transaction,BUY LONG 21.635920110614226 KUCOIN-DEGOUSDT 4.5905 28/06/2021,99.41901095904238,0.0,106.92871471753575
2021-06-28 08:21:00+00:00,symbol_transaction,SELL LONG 21.462476419284254 KUCOIN-DEGOUSDT 4.6607 28/06/2021,0.0,99.93,206.86
2021-06-28 08:24:00+00:00,symbol_transaction,SELL LONG 21.61787208220866 KUCOIN-DEGOUSDT 4.65 28/06/2021,0.0,100.42,307.28
2021-06-28 08:28:00+00:00,symbol_transaction,SELL LONG 21.65833904336959 KUCOIN-DEGOUSDT 4.6085 28/06/2021,0.0,99.71,406.99
2021-06-28 08:44:00+00:00,symbol_transaction,BUY LONG 23.485030861442343 KUCOIN-DEGOUSDT 4.6249 28/06/2021,108.72453515031579,0.0,298.26953835370614
2021-06-28 08:47:00+00:00,symbol_transaction,BUY LONG 23.441942175025332 KUCOIN-DEGOUSDT 4.6138 28/06/2021,108.26458923993901,0.0,190.0049491137671
2021-06-28 09:22:00+00:00,symbol_transaction,BUY LONG 17.81171450839483 KUCOIN-DEGOUSDT 4.5415 28/06/2021,80.97279334131498,0.0,109.03215577245213
2021-06-28 09:41:00+00:00,symbol_transaction,SELL LONG 22.127364917667112 KUCOIN-DEGOUSDT 4.5345 28/06/2021,0.0,100.24,209.27
2021-06-28 09:50:00+00:00,symbol_transaction,SELL LONG 22.211793239877274 KUCOIN-DEGOUSDT 4.4875 28/06/2021,0.0,99.58,308.84
2021-06-28 10:16:00+00:00,symbol_transaction,BUY LONG 23.65398037265591 KUCOIN-DEGOUSDT 4.4212 28/06/2021,104.68355700160988,0.0,204.16054519556997
2021-06-28 11:02:00+00:00,symbol_transaction,BUY LONG 20.68517778488848 KUCOIN-DEGOUSDT 4.3935 28/06/2021,90.97120892650545,0.0,113.18933626906451
2021-06-28 16:07:00+00:00,symbol_transaction,SELL LONG 21.55414429432177 KUCOIN-DEGOUSDT 4.64 28/06/2021,0.0,99.91,213.1
2021-06-28 16:40:00+00:00,symbol_transaction,BUY LONG 21.55414429432177 KUCOIN-DEGOUSDT 4.5428 28/06/2021,98.01408286694517,0.0,115.08647169824671
2021-06-28 17:49:00+00:00,symbol_transaction,SELL LONG 22.072729404863942 KUCOIN-DEGOUSDT 4.5232 28/06/2021,0.0,99.74,214.83
2021-06-28 18:02:00+00:00,symbol_transaction,BUY LONG 22.072729404863942 KUCOIN-DEGOUSDT 4.4959 28/06/2021,99.33602091545912,0.0,115.48998105722411
2021-06-29 02:30:00+00:00,symbol_transaction,SELL LONG 21.621080297497016 KUCOIN-DEGOUSDT 4.6217 29/06/2021,0.0,99.83,215.32
2021-06-29 05:35:00+00:00,symbol_transaction,SELL LONG 22.018440311434315 KUCOIN-DEGOUSDT 4.5322 29/06/2021,0.0,99.69,315.01
2021-06-29 06:19:00+00:00,symbol_transaction,SELL LONG 21.805792500712826 KUCOIN-DEGOUSDT 4.5806 29/06/2021,0.0,99.78,414.79
2021-06-29 06:42:00+00:00,symbol_transaction,BUY LONG 23.615857189781412 KUCOIN-DEGOUSDT 4.5913 29/06/2021,108.53591260055885,0.0,306.2562018407358
2021-06-29 06:50:00+00:00,symbol_transaction,BUY LONG 23.564400678811598 KUCOIN-DEGOUSDT 4.6297 29/06/2021,109.20520192851674,0.0,197.05099991221905
2021-06-29 07:02:00+00:00,symbol_transaction,BUY LONG 18.26505524105115 KUCOIN-DEGOUSDT 4.6249 29/06/2021,84.55852803832181,0.0,112.49247187389724
2021-06-29 07:22:00+00:00,symbol_transaction,SELL LONG 21.55165522417198 KUCOIN-DEGOUSDT 4.6366 29/06/2021,0.0,99.83,212.32
2021-06-29 07:24:00+00:00,symbol_transaction,SELL LONG 21.59519806220229 KUCOIN-DEGOUSDT 4.6472 29/06/2021,0.0,100.26,312.58
2021-06-29 07:30:00+00:00,symbol_transaction,BUY LONG 23.546333651108494 KUCOIN-DEGOUSDT 4.6249 29/06/2021,109.0083379415147,0.0,203.56745937039778
2021-06-29 07:45:00+00:00,symbol_transaction,SELL LONG 21.836605974945215 KUCOIN-DEGOUSDT 4.5687 29/06/2021,0.0,99.67,303.23
2021-06-29 08:05:00+00:00,symbol_transaction,SELL LONG 21.88752956676581 KUCOIN-DEGOUSDT 4.56 29/06/2021,0.0,99.71,402.94
2021-06-29 08:35:00+00:00,symbol_transaction,BUY LONG 23.645241525722934 KUCOIN-DEGOUSDT 4.5251 29/06/2021,107.10407951047691,0.0,295.83584436556293
2021-06-29 08:36:00+00:00,symbol_transaction,BUY LONG 23.672074362215568 KUCOIN-DEGOUSDT 4.5726 29/06/2021,108.35117015589559,0.0,187.48467420966733
2021-06-29 08:37:00+00:00,symbol_transaction,BUY LONG 16.007339289038285 KUCOIN-DEGOUSDT 4.5786 29/06/2021,73.36449487245947,0.0,114.12017933720786
2021-06-29 15:09:00+00:00,symbol_transaction,SELL LONG 21.21031782166141 KUCOIN-DEGOUSDT 4.736 29/06/2021,0.0,100.35,214.47
2021-06-29 15:16:00+00:00,symbol_transaction,BUY LONG 21.21031782166141 KUCOIN-DEGOUSDT 4.7065 29/06/2021,99.92618718847707,0.0,114.54560528691583
2021-06-30 00:29:00+00:00,symbol_transaction,SELL LONG 21.156152296905635 KUCOIN-DEGOUSDT 4.7381 30/06/2021,0.0,100.14,214.69
2021-06-30 03:08:00+00:00,symbol_transaction,SELL LONG 21.584963459099452 KUCOIN-DEGOUSDT 4.6338 30/06/2021,0.0,99.92,314.61
2021-06-30 03:30:00+00:00,symbol_transaction,SELL LONG 21.826544423241046 KUCOIN-DEGOUSDT 4.5646 30/06/2021,0.0,99.53,414.14
2021-06-30 03:57:00+00:00,symbol_transaction,SELL LONG 21.94413214769634 KUCOIN-DEGOUSDT 4.5319 30/06/2021,0.0,99.35,513.48
2021-06-30 04:10:00+00:00,symbol_transaction,SELL LONG 21.97148758995674 KUCOIN-DEGOUSDT 4.5234 30/06/2021,0.0,99.29,612.77
2021-06-30 04:43:00+00:00,symbol_transaction,SELL LONG 22.006514444449465 KUCOIN-DEGOUSDT 4.4738 30/06/2021,0.0,98.35,711.13
2021-06-30 05:07:00+00:00,symbol_transaction,SELL LONG 22.011674389065387 KUCOIN-DEGOUSDT 4.4834 30/06/2021,0.0,98.59,809.71
2021-06-30 05:24:00+00:00,symbol_transaction,SELL LONG 22.087819163298164 KUCOIN-DEGOUSDT 4.4642 30/06/2021,0.0,98.51,908.22
2021-06-30 05:31:00+00:00,symbol_transaction,BUY LONG 24.11866637003209 KUCOIN-DEGOUSDT 4.4356 30/06/2021,107.08773730746526,0.0,801.131979978805
2021-06-30 06:07:00+00:00,symbol_transaction,BUY LONG 23.984612445386315 KUCOIN-DEGOUSDT 4.4761 30/06/2021,107.46488129056047,0.0,693.6670986882446
2021-06-30 06:34:00+00:00,symbol_transaction,BUY LONG 23.861879456663956 KUCOIN-DEGOUSDT 4.5117 30/06/2021,107.76529918617541,0.0,585.9017995020691
2021-06-30 09:04:00+00:00,symbol_transaction,BUY LONG 24.188441309496213 KUCOIN-DEGOUSDT 4.3891 30/06/2021,106.27165323926134,0.0,479.6301462628078
2021-06-30 10:10:00+00:00,symbol_transaction,BUY LONG 24.163685336530683 KUCOIN-DEGOUSDT 4.3981 30/06/2021,106.3805787830742,0.0,373.24956747973357
2021-06-30 11:03:00+00:00,symbol_transaction,SELL LONG 21.91043990814368 KUCOIN-DEGOUSDT 4.5112 30/06/2021,0.0,98.74,471.99
2021-06-30 11:04:00+00:00,symbol_transaction,SELL LONG 21.92661668164144 KUCOIN-DEGOUSDT 4.4905 30/06/2021,0.0,98.36,570.36
2021-06-30 11:05:00+00:00,symbol_transaction,SELL LONG 21.994932506963014 KUCOIN-DEGOUSDT 4.4516 30/06/2021,0.0,97.81,668.17
2021-06-30 11:06:00+00:00,symbol_transaction,BUY LONG 24.101201500686315 KUCOIN-DEGOUSDT 4.4516 30/06/2021,107.39619750905565,0.0,560.7746437509326
2021-06-30 13:05:00+00:00,symbol_transaction,SELL LONG 22.172526223555074 KUCOIN-DEGOUSDT 4.4313 30/06/2021,0.0,98.15,658.93
2021-06-30 13:17:00+00:00,symbol_transaction,SELL LONG 22.185462884088828 KUCOIN-DEGOUSDT 4.3777 30/06/2021,0.0,97.02,755.95
2021-06-30 14:40:00+00:00,symbol_transaction,SELL LONG 22.281711345619073 KUCOIN-DEGOUSDT 4.3577 30/06/2021,0.0,97.0,852.95
2021-06-30 15:09:00+00:00,symbol_transaction,SELL LONG 22.38315313234202 KUCOIN-DEGOUSDT 4.3138 30/06/2021,0.0,96.46,949.41
2021-06-30 15:20:00+00:00,symbol_transaction,SELL LONG 22.352592181513934 KUCOIN-DEGOUSDT 4.3 30/06/2021,0.0,96.02,1045.43
2021-06-30 15:37:00+00:00,symbol_transaction,SELL LONG 3.8819992933142657 KUCOIN-DEGOUSDT 4.289 30/06/2021,0.0,16.63,1062.07
2021-06-30 19:02:00+00:00,symbol_transaction,BUY LONG 24.033473650695218 KUCOIN-DEGOUSDT 4.4147 30/06/2021,106.2066767018499,0.0,955.860090316649
2021-06-30 19:49:00+00:00,symbol_transaction,BUY LONG 23.85948990475239 KUCOIN-DEGOUSDT 4.45 30/06/2021,106.28090480622429,0.0,849.5791855104247
2021-07-01 00:58:00+00:00,symbol_transaction,BUY LONG 23.147748933542246 KUCOIN-DEGOUSDT 4.6185 01/07/2021,107.01478632801442,0.0,742.5643991824103
2021-07-01 01:53:00+00:00,symbol_transaction,BUY LONG 23.015913686766094 KUCOIN-DEGOUSDT 4.6875 01/07/2021,107.99498250212278,0.0,634.5694166802875
2021-07-01 02:16:00+00:00,symbol_transaction,SELL LONG 22.13600376490322 KUCOIN-DEGOUSDT 4.6219 01/07/2021,0.0,102.21,736.78
2021-07-01 02:43:00+00:00,symbol_transaction,SELL LONG 22.28933721622217 KUCOIN-DEGOUSDT 4.5406 01/07/2021,0.0,101.11,837.88
2021-07-01 03:38:00+00:00,symbol_transaction,SELL LONG 22.267254985816596 KUCOIN-DEGOUSDT 4.5534 01/07/2021,0.0,101.29,939.17
2021-07-01 04:08:00+00:00,symbol_transaction,BUY LONG 23.130090035595202 KUCOIN-DEGOUSDT 4.6033 01/07/2021,106.58121820431624,0.0,832.5923686141559
2021-07-01 04:09:00+00:00,symbol_transaction,BUY LONG 23.11315761194999 KUCOIN-DEGOUSDT 4.6089 01/07/2021,106.63275834983403,0.0,725.9596102643219
2021-07-01 04:15:00+00:00,symbol_transaction,BUY LONG 23.05992736068615 KUCOIN-DEGOUSDT 4.6249 01/07/2021,106.7565079084878,0.0,619.2031023558341
2021-07-01 04:19:00+00:00,symbol_transaction,SELL LONG 22.147741020695676 KUCOIN-DEGOUSDT 4.6626 01/07/2021,0.0,103.16,722.37
2021-07-01 04:36:00+00:00,symbol_transaction,SELL LONG 22.32539440221172 KUCOIN-DEGOUSDT 4.5595 01/07/2021,0.0,101.69,824.06
2021-07-01 06:13:00+00:00,symbol_transaction,BUY LONG 23.337109753485382 KUCOIN-DEGOUSDT 4.5425 01/07/2021,106.11482987626258,0.0,717.9419068464915
2021-07-01 06:35:00+00:00,symbol_transaction,BUY LONG 23.211656917007694 KUCOIN-DEGOUSDT 4.6089 01/07/2021,107.08718577036156,0.0,610.85472107613
2021-07-01 06:36:00+00:00,symbol_transaction,BUY LONG 23.10498588304377 KUCOIN-DEGOUSDT 4.6249 01/07/2021,106.96510745969962,0.0,503.8896136164303
2021-07-01 06:37:00+00:00,symbol_transaction,BUY LONG 23.056871498675633 KUCOIN-DEGOUSDT 4.6249 01/07/2021,106.74236071921916,0.0,397.14725289721116
2021-07-01 06:48:00+00:00,symbol_transaction,SELL LONG 22.519127786997718 KUCOIN-DEGOUSDT 4.4985 01/07/2021,0.0,101.2,498.35
2021-07-01 06:55:00+00:00,symbol_transaction,BUY LONG 23.33410351426105 KUCOIN-DEGOUSDT 4.482 01/07/2021,104.68803540286893,0.0,393.6602115478016
2021-07-01 06:59:00+00:00,symbol_transaction,SELL LONG 22.797798941757467 KUCOIN-DEGOUSDT 4.4834 01/07/2021,0.0,102.11,495.77
2021-07-01 07:56:00+00:00,symbol_transaction,BUY LONG 23.659246768524024 KUCOIN-DEGOUSDT 4.3524 01/07/2021,103.0774801409593,0.0,392.6921715305423
2021-07-01 08:12:00+00:00,symbol_transaction,SELL LONG 23.15895624639335 KUCOIN-DEGOUSDT 4.3652 01/07/2021,0.0,100.99,493.68
2021-07-01 09:15:00+00:00,symbol_transaction,SELL LONG 23.189825890578156 KUCOIN-DEGOUSDT 4.3574 01/07/2021,0.0,100.95,594.63
2021-07-01 09:53:00+00:00,symbol_transaction,BUY LONG 23.962985876031293 KUCOIN-DEGOUSDT 4.2584 01/07/2021,102.14602303354614,0.0,492.4848308162152
2021-07-01 10:02:00+00:00,symbol_transaction,BUY LONG 23.93433470705531 KUCOIN-DEGOUSDT 4.2681 01/07/2021,102.25628809714594,0.0,390.22854271906925
2021-07-01 10:27:00+00:00,symbol_transaction,SELL LONG 23.406908116946585 KUCOIN-DEGOUSDT 4.2783 01/07/2021,0.0,100.04,490.27
2021-07-01 11:16:00+00:00,symbol_transaction,BUY LONG 23.775844613402356 KUCOIN-DEGOUSDT 4.3302 01/07/2021,103.05711650729982,0.0,387.21305943350524
2021-07-01 11:17:00+00:00,symbol_transaction,BUY LONG 23.768242842025934 KUCOIN-DEGOUSDT 4.3302 01/07/2021,103.02416639969523,0.0,284.18889303381
2021-07-01 13:20:00+00:00,symbol_transaction,BUY LONG 23.654389893032498 KUCOIN-DEGOUSDT 4.4051 01/07/2021,104.30415287071526,0.0,179.88474016309476
2021-07-01 13:24:00+00:00,symbol_transaction,BUY LONG 15.33901057408832 KUCOIN-DEGOUSDT 4.4056 01/07/2021,67.6451225301887,0.0,112.23961763290606
2021-07-01 13:49:00+00:00,symbol_transaction,SELL LONG 22.863882304553233 KUCOIN-DEGOUSDT 4.4355 01/07/2021,0.0,101.31,213.55
2021-07-01 15:22:00+00:00,symbol_transaction,SELL LONG 23.01200473545914 KUCOIN-DEGOUSDT 4.4017 01/07/2021,0.0,101.19,314.74
2021-07-01 17:00:00+00:00,symbol_transaction,SELL LONG 23.19474835391624 KUCOIN-DEGOUSDT 4.35 01/07/2021,0.0,100.8,415.54
2021-07-01 17:54:00+00:00,symbol_transaction,BUY LONG 23.55226122848874 KUCOIN-DEGOUSDT 4.441 01/07/2021,104.7001877078342,0.0,310.8376746239784
2021-07-01 18:29:00+00:00,symbol_transaction,BUY LONG 23.60465331253195 KUCOIN-DEGOUSDT 4.4065 01/07/2021,104.11791872649373,0.0,206.71975589748467
2021-07-01 19:02:00+00:00,symbol_transaction,SELL LONG 23.13520465416007 KUCOIN-DEGOUSDT 4.386 01/07/2021,0.0,101.37,308.09
2021-07-02 00:11:00+00:00,symbol_transaction,BUY LONG 23.57974486743764 KUCOIN-DEGOUSDT 4.4125 02/07/2021,104.14966985179615,0.0,203.93962265122144
2021-07-02 01:34:00+00:00,symbol_transaction,BUY LONG 21.469180639630338 KUCOIN-DEGOUSDT 4.3225 02/07/2021,92.89333384811692,0.0,111.04628880310452
2021-07-02 01:56:00+00:00,symbol_transaction,SELL LONG 23.538259755303756 KUCOIN-DEGOUSDT 4.3136 02/07/2021,0.0,101.43,212.48
2021-07-02 03:15:00+00:00,symbol_transaction,SELL LONG 23.721780320233563 KUCOIN-DEGOUSDT 4.2833 02/07/2021,0.0,101.51,313.99
2021-07-02 03:27:00+00:00,symbol_transaction,SELL LONG 23.732822670770656 KUCOIN-DEGOUSDT 4.2389 02/07/2021,0.0,100.5,414.49
2021-07-02 03:28:00+00:00,symbol_transaction,SELL LONG 23.91104107260364 KUCOIN-DEGOUSDT 4.2389 02/07/2021,0.0,101.26,515.74
2021-07-02 03:37:00+00:00,symbol_transaction,SELL LONG 23.861410393595243 KUCOIN-DEGOUSDT 4.2197 02/07/2021,0.0,100.59,616.33
2021-07-02 04:21:00+00:00,symbol_transaction,BUY LONG 23.824374659311065 KUCOIN-DEGOUSDT 4.2218 02/07/2021,100.68232668161613,0.0,515.6458808008804
2021-07-02 05:50:00+00:00,symbol_transaction,SELL LONG 24.08391333808493 KUCOIN-DEGOUSDT 4.1875 02/07/2021,0.0,100.75,616.4
2021-07-02 06:20:00+00:00,symbol_transaction,SELL LONG 24.142698038033732 KUCOIN-DEGOUSDT 4.16 02/07/2021,0.0,100.33,716.73
2021-07-02 06:24:00+00:00,symbol_transaction,SELL LONG 24.1379116124944 KUCOIN-DEGOUSDT 4.1604 02/07/2021,0.0,100.32,817.05
2021-07-02 08:17:00+00:00,symbol_transaction,BUY LONG 23.659211302043516 KUCOIN-DEGOUSDT 4.2362 02/07/2021,100.32537606863447,0.0,716.7271747679044
2021-07-02 08:50:00+00:00,symbol_transaction,BUY LONG 23.834247909937602 KUCOIN-DEGOUSDT 4.1922 02/07/2021,100.01785202212845,0.0,616.709322745776
2021-07-02 09:04:00+00:00,symbol_transaction,BUY LONG 23.914712888704678 KUCOIN-DEGOUSDT 4.1687 02/07/2021,99.79295688276234,0.0,516.9163658630137
2021-07-02 10:42:00+00:00,symbol_transaction,BUY LONG 24.09842365680307 KUCOIN-DEGOUSDT 4.107 02/07/2021,99.0711981844487,0.0,417.84516767856496
2021-07-02 11:15:00+00:00,symbol_transaction,BUY LONG 23.96363167283457 KUCOIN-DEGOUSDT 4.1689 02/07/2021,100.00188606496091,0.0,317.84328161360406
2021-07-02 12:32:00+00:00,symbol_transaction,BUY LONG 24.01444884041705 KUCOIN-DEGOUSDT 4.1428 02/07/2021,99.58654571473583,0.0,218.25673589886821
2021-07-02 12:48:00+00:00,symbol_transaction,BUY LONG 23.820786271068357 KUCOIN-DEGOUSDT 4.1763 02/07/2021,99.58223245356666,0.0,118.67450344530155
