timestamp,type,description,debit,credit,balance
2021-07-03 18:08:54.810101+00:00,subscription,SUBSCRIPTION,0.0,1000.0,1000.0
2021-06-26 01:36:00+00:00,symbol_transaction,BUY LONG 164.82445124583387 BINANCE-OGNUSDT 0.6072 26/06/2021,100.1814882032668,0.0,899.8185117967332
2021-06-26 05:06:00+00:00,symbol_transaction,BUY LONG 158.79017043811191 BINANCE-OGNUSDT 0.631 26/06/2021,100.29679414399506,0.0,799.5217176527382
2021-06-26 06:22:00+00:00,symbol_transaction,SELL LONG 162.65469768056525 BINANCE-OGNUSDT 0.6281 26/06/2021,0.0,102.06,901.58
2021-06-26 07:20:00+00:00,symbol_transaction,SELL LONG 160.9599240033805 BINANCE-OGNUSDT 0.5939 26/06/2021,0.0,95.5,997.08
2021-06-26 07:37:00+00:00,symbol_transaction,BUY LONG 170.44582293425776 BINANCE-OGNUSDT 0.5862 26/06/2021,100.01525674546596,0.0,897.066217871564
2021-06-26 07:40:00+00:00,symbol_transaction,BUY LONG 171.14106253296748 BINANCE-OGNUSDT 0.5822 26/06/2021,99.73796493330038,0.0,797.3282529382636
2021-06-26 07:52:00+00:00,symbol_transaction,BUY LONG 171.12692401319157 BINANCE-OGNUSDT 0.5813 26/06/2021,99.57555700979714,0.0,697.7526959284664
2021-06-26 07:55:00+00:00,symbol_transaction,BUY LONG 171.00975355030278 BINANCE-OGNUSDT 0.5819 26/06/2021,99.6100861665121,0.0,598.1426097619543
2021-06-26 08:05:00+00:00,symbol_transaction,BUY LONG 171.36460152596035 BINANCE-OGNUSDT 0.5783 26/06/2021,99.19924921152534,0.0,498.94336055042896
2021-06-26 08:06:00+00:00,symbol_transaction,BUY LONG 171.6148016109011 BINANCE-OGNUSDT 0.5747 26/06/2021,98.72565351227065,0.0,400.2177070381583
2021-06-26 08:07:00+00:00,symbol_transaction,BUY LONG 172.13757213634935 BINANCE-OGNUSDT 0.573 26/06/2021,98.7334636629623,0.0,301.484243375196
2021-06-26 08:17:00+00:00,symbol_transaction,BUY LONG 172.55711343478404 BINANCE-OGNUSDT 0.5674 26/06/2021,98.00681506905937,0.0,203.47742830613663
2021-06-26 10:04:00+00:00,symbol_transaction,BUY LONG 171.58495944310081 BINANCE-OGNUSDT 0.589 26/06/2021,101.16460465309835,0.0,102.31282365303828
2021-06-26 10:07:00+00:00,symbol_transaction,BUY LONG 87.77318215967853 BINANCE-OGNUSDT 0.5839 26/06/2021,51.302011824099324,0.0,51.010811828938955
2021-06-26 11:13:00+00:00,symbol_transaction,SELL LONG 161.53263921293546 BINANCE-OGNUSDT 0.5908 26/06/2021,0.0,95.34,146.35
2021-06-26 11:57:00+00:00,symbol_transaction,SELL LONG 157.6951562981808 BINANCE-OGNUSDT 0.6068 26/06/2021,0.0,95.59,241.94
2021-06-26 13:02:00+00:00,symbol_transaction,SELL LONG 158.7912756576128 BINANCE-OGNUSDT 0.6034 26/06/2021,0.0,95.72,337.66
2021-06-26 13:33:00+00:00,symbol_transaction,BUY LONG 171.5389432505695 BINANCE-OGNUSDT 0.6002 26/06/2021,103.0606314127308,0.0,234.60080267692956
2021-06-26 13:53:00+00:00,symbol_transaction,BUY LONG 172.55058495032873 BINANCE-OGNUSDT 0.5842 26/06/2021,100.90485577971003,0.0,133.69594689721953
2021-06-26 14:21:00+00:00,symbol_transaction,SELL LONG 160.99357837508697 BINANCE-OGNUSDT 0.5893 26/06/2021,0.0,94.78,228.47
2021-06-26 14:49:00+00:00,symbol_transaction,BUY LONG 172.01145664166532 BINANCE-OGNUSDT 0.5946 26/06/2021,102.38029013125333,0.0,126.09429898666852
2021-06-26 15:42:00+00:00,symbol_transaction,SELL LONG 158.88546892869263 BINANCE-OGNUSDT 0.598 26/06/2021,0.0,94.92,221.01
2021-06-26 18:07:00+00:00,symbol_transaction,BUY LONG 171.6335170058537 BINANCE-OGNUSDT 0.5997 26/06/2021,103.03154876855886,0.0,117.98124712704846
2021-06-27 01:31:00+00:00,symbol_transaction,SELL LONG 152.46402737907565 BINANCE-OGNUSDT 0.6286 27/06/2021,0.0,95.74,213.72
2021-06-27 01:40:00+00:00,symbol_transaction,SELL LONG 151.7191842942882 BINANCE-OGNUSDT 0.6328 27/06/2021,0.0,95.91,309.64
2021-06-27 01:52:00+00:00,symbol_transaction,BUY LONG 170.82235145157028 BINANCE-OGNUSDT 0.6283 27/06/2021,107.43501110043863,0.0,202.20117667109045
2021-06-27 03:03:00+00:00,symbol_transaction,BUY LONG 170.70909823057497 BINANCE-OGNUSDT 0.628 27/06/2021,107.31251900248988,0.0,94.88865766860057
2021-06-27 10:26:00+00:00,symbol_transaction,BUY LONG 72.81537861531001 BINANCE-OGNUSDT 0.6025 27/06/2021,43.915136881340004,0.0,50.97352078726057
2021-06-27 19:35:00+00:00,symbol_transaction,SELL LONG 157.92624540333424 BINANCE-OGNUSDT 0.6047 27/06/2021,0.0,95.4,146.38
2021-06-27 19:51:00+00:00,symbol_transaction,SELL LONG 152.45648352935 BINANCE-OGNUSDT 0.6338 27/06/2021,0.0,96.53,242.91
2021-06-28 00:27:00+00:00,symbol_transaction,BUY LONG 167.02315097784856 BINANCE-OGNUSDT 0.6936 28/06/2021,115.963104775754,0.0,126.94321094794853
2021-06-28 02:24:00+00:00,symbol_transaction,SELL LONG 144.09262126970307 BINANCE-OGNUSDT 0.6821 28/06/2021,0.0,98.19,225.13
2021-06-28 03:11:00+00:00,symbol_transaction,BUY LONG 167.63440243106723 BINANCE-OGNUSDT 0.6732 28/06/2021,112.96433119631106,0.0,112.16617114273387
2021-06-28 05:39:00+00:00,symbol_transaction,BUY LONG 119.81779679347153 BINANCE-OGNUSDT 0.674 28/06/2021,80.83795223383862,0.0,31.328218908895252
2021-06-28 16:06:00+00:00,symbol_transaction,SELL LONG 140.75496711835117 BINANCE-OGNUSDT 0.6979 28/06/2021,0.0,98.13,129.46
2021-06-29 09:40:00+00:00,symbol_transaction,BUY LONG 140.75496711835117 BINANCE-OGNUSDT 0.6957 29/06/2021,98.02115385486114,0.0,31.441723714379478
2021-06-29 13:18:00+00:00,symbol_transaction,SELL LONG 136.0139560027421 BINANCE-OGNUSDT 0.723 29/06/2021,0.0,98.24,129.68
2021-06-29 14:51:00+00:00,symbol_transaction,SELL LONG 136.32452689148573 BINANCE-OGNUSDT 0.7174 29/06/2021,0.0,97.7,227.38
2021-06-29 15:49:00+00:00,symbol_transaction,BUY LONG 167.92212719728147 BINANCE-OGNUSDT 0.7069 29/06/2021,118.82285586747403,0.0,108.56003632305791
2021-06-29 18:29:00+00:00,symbol_transaction,BUY LONG 104.41635569694634 BINANCE-OGNUSDT 0.701 29/06/2021,73.26906120890294,0.0,35.290975114154975
2021-06-29 19:00:00+00:00,symbol_transaction,SELL LONG 139.76395438859208 BINANCE-OGNUSDT 0.7008 29/06/2021,0.0,97.85,133.14
2021-06-30 07:42:00+00:00,symbol_transaction,SELL LONG 144.39153051197087 BINANCE-OGNUSDT 0.679 30/06/2021,0.0,97.94,231.08
2021-06-30 08:03:00+00:00,symbol_transaction,BUY LONG 168.67529270210935 BINANCE-OGNUSDT 0.6785 30/06/2021,114.56063228447957,0.0,116.52278285437583
2021-06-30 08:04:00+00:00,symbol_transaction,SELL LONG 144.29154068298593 BINANCE-OGNUSDT 0.6772 30/06/2021,0.0,97.62,214.14
2021-06-30 08:22:00+00:00,symbol_transaction,SELL LONG 144.9113922539001 BINANCE-OGNUSDT 0.6776 30/06/2021,0.0,98.09,312.23
2021-06-30 08:31:00+00:00,symbol_transaction,BUY LONG 168.64061901092612 BINANCE-OGNUSDT 0.676 30/06/2021,114.11505950983745,0.0,198.1180078955574
2021-07-01 01:42:00+00:00,symbol_transaction,SELL LONG 140.00225529752782 BINANCE-OGNUSDT 0.7026 01/07/2021,0.0,98.27,296.39
2021-07-01 02:06:00+00:00,symbol_transaction,BUY LONG 167.29661288157143 BINANCE-OGNUSDT 0.7045 01/07/2021,117.97832423884215,0.0,178.40690264418623
2021-07-01 02:08:00+00:00,symbol_transaction,BUY LONG 167.46550177864546 BINANCE-OGNUSDT 0.6991 01/07/2021,117.1922074257445,0.0,61.21469521844173
2021-07-01 03:53:00+00:00,symbol_transaction,BUY LONG 41.28264676172455 BINANCE-OGNUSDT 0.6737 01/07/2021,27.839931242497205,0.0,33.37476397594453
2021-07-01 19:41:00+00:00,symbol_transaction,SELL LONG 152.92746986293557 BINANCE-OGNUSDT 0.6419 01/07/2021,0.0,98.07,131.44
2021-07-02 12:48:00+00:00,symbol_transaction,SELL LONG 157.03126857283237 BINANCE-OGNUSDT 0.6274 02/07/2021,0.0,98.42,229.86
