timestamp,type,description,debit,credit,balance
2021-07-03 18:22:59.766801+00:00,symbol_transaction,BUY LONG 169.12155053343474 KUCOIN-UNFIUSDT 0 03/07/2021,0.0,0.0,0.0
2021-06-26 01:03:00+00:00,symbol_transaction,SELL LONG 16.52880541034082 KUCOIN-UNFIUSDT 6.073 26/06/2021,0.0,100.28,100.28
2021-06-26 01:07:00+00:00,symbol_transaction,BUY LONG 16.52880541034082 KUCOIN-UNFIUSDT 5.981 26/06/2021,98.95764394440769,0.0,1.321411877335109
2021-06-26 08:07:00+00:00,symbol_transaction,SELL LONG 17.827078046859654 KUCOIN-UNFIUSDT 5.543 26/06/2021,0.0,98.72,100.04
2021-06-26 08:08:00+00:00,symbol_transaction,BUY LONG 16.91729434178577 KUCOIN-UNFIUSDT 5.543 26/06/2021,93.86633509905504,0.0,6.171754898409404
2021-06-26 08:12:00+00:00,symbol_transaction,BUY LONG 0.9097837050738846 KUCOIN-UNFIUSDT 5.538 26/06/2021,5.0434205408578725,0.0,1.1283343575515312
2021-06-26 08:22:00+00:00,symbol_transaction,BUY LONG 0.20357723503722777 KUCOIN-UNFIUSDT 5.537 26/06/2021,1.1283343575515312,0.0,0.0
2021-06-26 08:40:00+00:00,symbol_transaction,SELL LONG 18.050518068371634 KUCOIN-UNFIUSDT 5.605 26/06/2021,0.0,101.07,101.07
2021-06-26 08:50:00+00:00,symbol_transaction,BUY LONG 16.82568120815272 KUCOIN-UNFIUSDT 5.534 26/06/2021,93.20643312572307,0.0,7.865547493726737
2021-06-26 08:57:00+00:00,symbol_transaction,SELL LONG 18.24360456659228 KUCOIN-UNFIUSDT 5.534 26/06/2021,0.0,100.86,108.72
2021-06-26 09:32:00+00:00,symbol_transaction,BUY LONG 16.82253251004104 KUCOIN-UNFIUSDT 5.533 26/06/2021,93.17215145043514,0.0,15.552543607141743
2021-06-26 09:40:00+00:00,symbol_transaction,BUY LONG 2.7484533169186633 KUCOIN-UNFIUSDT 5.653 26/06/2021,15.552543607141743,0.0,0.0
2021-06-26 10:47:00+00:00,symbol_transaction,SELL LONG 18.051874780522578 KUCOIN-UNFIUSDT 5.587 26/06/2021,0.0,100.75,100.75
2021-06-26 10:52:00+00:00,symbol_transaction,BUY LONG 16.8067071583749 KUCOIN-UNFIUSDT 5.606 26/06/2021,94.31261873017952,0.0,6.442349844201331
2021-06-26 11:04:00+00:00,symbol_transaction,BUY LONG 0.9169245822828174 KUCOIN-UNFIUSDT 5.704 26/06/2021,5.235367955158532,0.0,1.2069818890427992
2021-06-26 11:21:00+00:00,symbol_transaction,BUY LONG 0.20991923971620294 KUCOIN-UNFIUSDT 5.735 26/06/2021,1.2050907266121962,0.0,0.001891162430603055
2021-06-26 13:41:00+00:00,symbol_transaction,SELL LONG 17.74137702781507 KUCOIN-UNFIUSDT 5.716 26/06/2021,0.0,101.31,101.31
2021-06-26 13:46:00+00:00,symbol_transaction,SELL LONG 17.860198249500172 KUCOIN-UNFIUSDT 5.694 26/06/2021,0.0,101.59,202.9
2021-06-26 13:47:00+00:00,symbol_transaction,SELL LONG 17.912130593804594 KUCOIN-UNFIUSDT 5.644 26/06/2021,0.0,100.99,303.9
2021-06-26 13:48:00+00:00,symbol_transaction,SELL LONG 18.02982159327571 KUCOIN-UNFIUSDT 5.644 26/06/2021,0.0,101.66,405.56
2021-06-26 13:51:00+00:00,symbol_transaction,SELL LONG 18.031546075672058 KUCOIN-UNFIUSDT 5.65 26/06/2021,0.0,101.78,507.33
2021-06-26 13:53:00+00:00,symbol_transaction,BUY LONG 16.806725558554476 KUCOIN-UNFIUSDT 5.591 26/06/2021,94.06036900047594,0.0,413.2739752636329
2021-06-26 14:23:00+00:00,symbol_transaction,BUY LONG 16.80768903686959 KUCOIN-UNFIUSDT 5.598 26/06/2021,94.18353267162436,0.0,319.09044259200857
2021-06-26 14:43:00+00:00,symbol_transaction,BUY LONG 16.732752267924194 KUCOIN-UNFIUSDT 5.659 26/06/2021,94.7853357292672,0.0,224.30510686274135
2021-06-26 15:05:00+00:00,symbol_transaction,BUY LONG 16.757140776000785 KUCOIN-UNFIUSDT 5.622 26/06/2021,94.30285408811909,0.0,130.00225277462226
2021-06-26 15:13:00+00:00,symbol_transaction,BUY LONG 16.728260727530973 KUCOIN-UNFIUSDT 5.689 26/06/2021,95.26224235420263,0.0,34.74001042041964
2021-06-26 16:04:00+00:00,symbol_transaction,BUY LONG 0.5782478533669178 KUCOIN-UNFIUSDT 5.7 26/06/2021,3.2993087769556224,0.0,31.440701643464013
2021-06-26 16:33:00+00:00,symbol_transaction,BUY LONG 0.5782478533669178 KUCOIN-UNFIUSDT 5.708 26/06/2021,3.3039393857653847,0.0,28.136762257698628
2021-06-26 16:42:00+00:00,symbol_transaction,BUY LONG 0.5782478533669178 KUCOIN-UNFIUSDT 5.661 26/06/2021,3.2767345590080312,0.0,24.860027698690597
2021-06-26 16:57:00+00:00,symbol_transaction,BUY LONG 0.5782478533669178 KUCOIN-UNFIUSDT 5.716 26/06/2021,3.3085699945751474,0.0,21.55145770411545
2021-06-26 18:13:00+00:00,symbol_transaction,BUY LONG 0.5782478533669178 KUCOIN-UNFIUSDT 5.837 26/06/2021,3.3786079528228017,0.0,18.17284975129265
2021-06-26 18:35:00+00:00,symbol_transaction,BUY LONG 0.5782478533669178 KUCOIN-UNFIUSDT 5.77 26/06/2021,3.3398266040410425,0.0,14.833023147251605
2021-06-27 00:12:00+00:00,symbol_transaction,BUY LONG 0.5782478533669178 KUCOIN-UNFIUSDT 5.77 27/06/2021,3.3398266040410425,0.0,11.493196543210562
2021-06-27 07:37:00+00:00,symbol_transaction,BUY LONG 0.5782478533669178 KUCOIN-UNFIUSDT 5.764 27/06/2021,3.336353647433721,0.0,8.15684289577684
2021-06-27 08:12:00+00:00,symbol_transaction,BUY LONG 0.5782478533669178 KUCOIN-UNFIUSDT 5.793 27/06/2021,3.3531396043691095,0.0,4.8037032914077304
2021-06-27 09:22:00+00:00,symbol_transaction,BUY LONG 0.5782478533669178 KUCOIN-UNFIUSDT 5.741 27/06/2021,3.323040647105654,0.0,1.4806626443020763
2021-06-27 09:28:00+00:00,symbol_transaction,BUY LONG 0.2576525798364806 KUCOIN-UNFIUSDT 5.741 27/06/2021,1.4806626443020763,0.0,0.0
2021-06-27 13:27:00+00:00,symbol_transaction,SELL LONG 18.260787550322974 KUCOIN-UNFIUSDT 5.778 27/06/2021,0.0,105.41,105.41
2021-06-27 13:42:00+00:00,symbol_transaction,BUY LONG 16.138689772794287 KUCOIN-UNFIUSDT 5.703 27/06/2021,92.13098672202007,0.0,13.274332913280304
2021-06-27 14:23:00+00:00,symbol_transaction,BUY LONG 0.3848101251440994 KUCOIN-UNFIUSDT 5.731 27/06/2021,2.2075521740280344,0.0,11.06678073925227
2021-06-27 14:50:00+00:00,symbol_transaction,BUY LONG 0.3848101251440994 KUCOIN-UNFIUSDT 5.747 27/06/2021,2.2137152929923425,0.0,8.853065446259928
2021-06-27 15:03:00+00:00,symbol_transaction,BUY LONG 0.3848101251440994 KUCOIN-UNFIUSDT 5.801 27/06/2021,2.2345158194968815,0.0,6.618549626763047
2021-06-27 15:08:00+00:00,symbol_transaction,BUY LONG 0.3848101251440994 KUCOIN-UNFIUSDT 5.802 27/06/2021,2.234901014432151,0.0,4.383648612330896
2021-06-27 15:48:00+00:00,symbol_transaction,BUY LONG 0.3848101251440994 KUCOIN-UNFIUSDT 5.802 27/06/2021,2.234901014432151,0.0,2.1487475978987454
2021-06-27 16:14:00+00:00,symbol_transaction,BUY LONG 0.3696574818153683 KUCOIN-UNFIUSDT 5.807 27/06/2021,2.1487475978987454,0.0,0.0
2021-06-28 07:19:00+00:00,symbol_transaction,SELL LONG 17.2641703862132 KUCOIN-UNFIUSDT 6.182 28/06/2021,0.0,106.62,106.62
2021-06-28 07:26:00+00:00,symbol_transaction,BUY LONG 15.927705223036938 KUCOIN-UNFIUSDT 6.094 28/06/2021,97.16049906481628,0.0,9.459875161426154
2021-06-28 07:39:00+00:00,symbol_transaction,BUY LONG 1.5441870484786708 KUCOIN-UNFIUSDT 6.12 28/06/2021,9.459875161426154,0.0,0.0
2021-06-29 00:17:00+00:00,symbol_transaction,SELL LONG 16.924038527977867 KUCOIN-UNFIUSDT 6.305 29/06/2021,0.0,106.6,106.6
2021-06-29 00:38:00+00:00,symbol_transaction,BUY LONG 15.925487527551308 KUCOIN-UNFIUSDT 6.298 29/06/2021,100.39901916896666,0.0,6.20033768701488
2021-06-29 00:59:00+00:00,symbol_transaction,BUY LONG 0.9763782382521136 KUCOIN-UNFIUSDT 6.344 29/06/2021,6.20033768701488,0.0,0.0
2021-06-30 03:56:00+00:00,symbol_transaction,SELL LONG 16.205730169142626 KUCOIN-UNFIUSDT 6.64 30/06/2021,0.0,107.5,107.5
2021-06-30 04:32:00+00:00,symbol_transaction,BUY LONG 15.83298941358501 KUCOIN-UNFIUSDT 6.603 30/06/2021,104.64977432699972,0.0,2.8486679477842074
2021-06-30 05:45:00+00:00,symbol_transaction,BUY LONG 0.4423786920035052 KUCOIN-UNFIUSDT 6.433 30/06/2021,2.8486679477842074,0.0,0.0
2021-06-30 09:48:00+00:00,symbol_transaction,SELL LONG 17.00383729274041 KUCOIN-UNFIUSDT 6.32 30/06/2021,0.0,107.36,107.36
2021-06-30 09:49:00+00:00,symbol_transaction,BUY LONG 15.78661008468241 KUCOIN-UNFIUSDT 6.32 30/06/2021,99.87114711092802,0.0,7.485640327501258
2021-06-30 12:25:00+00:00,symbol_transaction,BUY LONG 0.42858561575911835 KUCOIN-UNFIUSDT 6.464 30/06/2021,2.773147797687208,0.0,4.71249252981405
2021-06-30 12:34:00+00:00,symbol_transaction,BUY LONG 0.42858561575911835 KUCOIN-UNFIUSDT 6.456 30/06/2021,2.769715684076209,0.0,1.9427768457378405
2021-06-30 15:47:00+00:00,symbol_transaction,SELL LONG 17.927402750188154 KUCOIN-UNFIUSDT 6.155 30/06/2021,0.0,110.23,112.18
2021-06-30 16:06:00+00:00,symbol_transaction,BUY LONG 15.709258554634438 KUCOIN-UNFIUSDT 6.112 30/06/2021,96.11100327421161,0.0,16.064594335006916
2021-06-30 17:38:00+00:00,symbol_transaction,BUY LONG 0.04903706459577961 KUCOIN-UNFIUSDT 6.247 30/06/2021,0.30664087707236504,0.0,15.757953457934551
2021-06-30 17:39:00+00:00,symbol_transaction,BUY LONG 0.04903706459577961 KUCOIN-UNFIUSDT 6.247 30/06/2021,0.30664087707236504,0.0,15.451312580862187
2021-06-30 18:49:00+00:00,symbol_transaction,BUY LONG 0.04903706459577961 KUCOIN-UNFIUSDT 6.324 30/06/2021,0.31042050690021394,0.0,15.140892073961972
2021-06-30 19:06:00+00:00,symbol_transaction,BUY LONG 0.04903706459577961 KUCOIN-UNFIUSDT 6.364 30/06/2021,0.31238395096662896,0.0,14.828508122995343
2021-06-30 19:15:00+00:00,symbol_transaction,BUY LONG 0.04903706459577961 KUCOIN-UNFIUSDT 6.37 30/06/2021,0.31267846757659123,0.0,14.515829655418752
2021-06-30 19:42:00+00:00,symbol_transaction,BUY LONG 0.04903706459577961 KUCOIN-UNFIUSDT 6.39 30/06/2021,0.3136601896097987,0.0,14.202169465808954
2021-07-01 00:54:00+00:00,symbol_transaction,BUY LONG 0.04903706459577961 KUCOIN-UNFIUSDT 6.543 01/07/2021,0.3211703631638362,0.0,13.880999102645118
2021-07-01 00:58:00+00:00,symbol_transaction,BUY LONG 0.04903706459577961 KUCOIN-UNFIUSDT 6.523 01/07/2021,0.32018864113062867,0.0,13.560810461514489
2021-07-01 00:59:00+00:00,symbol_transaction,BUY LONG 0.04903706459577961 KUCOIN-UNFIUSDT 6.523 01/07/2021,0.32018864113062867,0.0,13.24062182038386
2021-07-01 01:02:00+00:00,symbol_transaction,BUY LONG 0.04903706459577961 KUCOIN-UNFIUSDT 6.479 01/07/2021,0.3180288526575722,0.0,12.922592967726287
2021-07-01 01:05:00+00:00,symbol_transaction,BUY LONG 0.04903706459577961 KUCOIN-UNFIUSDT 6.482 01/07/2021,0.3181761109625533,0.0,12.604416856763732
2021-07-01 02:15:00+00:00,symbol_transaction,SELL LONG 17.1398047734385 KUCOIN-UNFIUSDT 6.448 01/07/2021,0.0,110.41,123.01
2021-07-01 02:55:00+00:00,symbol_transaction,BUY LONG 15.680057390640707 KUCOIN-UNFIUSDT 6.311 01/07/2021,99.05579903452583,0.0,23.955561540190217
2021-07-01 03:43:00+00:00,symbol_transaction,BUY LONG 1.508784447393623 KUCOIN-UNFIUSDT 6.274 01/07/2021,9.475579736570538,0.0,14.47998180361968
2021-07-01 05:51:00+00:00,symbol_transaction,SELL LONG 17.135928450481295 KUCOIN-UNFIUSDT 6.458 01/07/2021,0.0,110.55,125.03
2021-07-01 06:08:00+00:00,symbol_transaction,BUY LONG 15.70209863661593 KUCOIN-UNFIUSDT 6.36 01/07/2021,99.96521267620619,0.0,25.067931234688487
2021-07-01 06:31:00+00:00,symbol_transaction,BUY LONG 1.4338298138653656 KUCOIN-UNFIUSDT 6.279 01/07/2021,9.01202041866189,0.0,16.055910816026596
2021-07-01 06:48:00+00:00,symbol_transaction,SELL LONG 17.61138136661105 KUCOIN-UNFIUSDT 6.236 01/07/2021,0.0,109.71,125.77
2021-07-01 06:49:00+00:00,symbol_transaction,SELL LONG 17.69195796393435 KUCOIN-UNFIUSDT 6.236 01/07/2021,0.0,110.22,235.99
2021-07-01 06:54:00+00:00,symbol_transaction,BUY LONG 15.75906123373057 KUCOIN-UNFIUSDT 6.146 01/07/2021,96.95204553285059,0.0,139.0353377243918
2021-07-01 07:24:00+00:00,symbol_transaction,BUY LONG 15.762646601951138 KUCOIN-UNFIUSDT 6.132 01/07/2021,96.75320551212754,0.0,42.28213221226427
2021-07-01 07:39:00+00:00,symbol_transaction,BUY LONG 3.7816314948636887 KUCOIN-UNFIUSDT 6.154 01/07/2021,23.29543237961053,0.0,18.98669983265374
2021-07-01 19:37:00+00:00,symbol_transaction,SELL LONG 18.35425417788328 KUCOIN-UNFIUSDT 6.0 01/07/2021,0.0,110.02,129.0
2021-07-01 19:38:00+00:00,symbol_transaction,SELL LONG 18.36471412535932 KUCOIN-UNFIUSDT 6.0 01/07/2021,0.0,110.08,239.08
2021-07-01 19:40:00+00:00,symbol_transaction,SELL LONG 18.380127214236577 KUCOIN-UNFIUSDT 6.001 01/07/2021,0.0,110.19,349.27
2021-07-01 19:50:00+00:00,symbol_transaction,BUY LONG 15.85250064606082 KUCOIN-UNFIUSDT 5.907 01/07/2021,93.73436203759753,0.0,255.53467807391348
2021-07-02 00:20:00+00:00,symbol_transaction,SELL LONG 17.898145947759826 KUCOIN-UNFIUSDT 6.196 02/07/2021,0.0,110.79,366.32
2021-07-02 00:42:00+00:00,symbol_transaction,BUY LONG 15.709199043573719 KUCOIN-UNFIUSDT 6.132 02/07/2021,96.42513734372923,0.0,269.8955561102118
2021-07-02 01:01:00+00:00,symbol_transaction,BUY LONG 15.670655953871725 KUCOIN-UNFIUSDT 6.184 02/07/2021,97.00424375516148,0.0,172.89131235505033
2021-07-02 01:03:00+00:00,symbol_transaction,BUY LONG 15.669090453776429 KUCOIN-UNFIUSDT 6.17 02/07/2021,96.77496638790036,0.0,76.11634596714997
2021-07-02 02:02:00+00:00,symbol_transaction,BUY LONG 10.095795367956327 KUCOIN-UNFIUSDT 5.967 02/07/2021,60.301852571556,0.0,15.81449339559397
2021-07-02 03:33:00+00:00,symbol_transaction,SELL LONG 18.010504660845594 KUCOIN-UNFIUSDT 6.169 02/07/2021,0.0,111.0,126.81
2021-07-02 03:40:00+00:00,symbol_transaction,BUY LONG 15.72075434973398 KUCOIN-UNFIUSDT 6.12 02/07/2021,96.30722763699234,0.0,30.502962208105345
2021-07-02 03:42:00+00:00,symbol_transaction,BUY LONG 2.2897503111116144 KUCOIN-UNFIUSDT 6.122 02/07/2021,14.031869256029928,0.0,16.471092952075416
2021-07-02 04:03:00+00:00,symbol_transaction,SELL LONG 18.408020142576348 KUCOIN-UNFIUSDT 6.01 02/07/2021,0.0,110.52,126.99
2021-07-02 04:06:00+00:00,symbol_transaction,BUY LONG 15.735394116460174 KUCOIN-UNFIUSDT 6.015 02/07/2021,94.74304400611845,0.0,32.24961780178393
2021-07-02 04:13:00+00:00,symbol_transaction,SELL LONG 18.15869612371747 KUCOIN-UNFIUSDT 6.13 02/07/2021,0.0,111.2,143.45
2021-07-02 04:15:00+00:00,symbol_transaction,BUY LONG 15.738861663911345 KUCOIN-UNFIUSDT 6.047 02/07/2021,95.26806937815357,0.0,48.18304285478004
2021-07-02 04:35:00+00:00,symbol_transaction,SELL LONG 18.49618311758461 KUCOIN-UNFIUSDT 5.981 02/07/2021,0.0,110.52,158.7
2021-07-02 05:20:00+00:00,symbol_transaction,BUY LONG 15.7847220212252 KUCOIN-UNFIUSDT 5.889 02/07/2021,93.0491842109782,0.0,65.64890419884914
2021-07-02 05:44:00+00:00,symbol_transaction,SELL LONG 18.85051261916589 KUCOIN-UNFIUSDT 5.86 02/07/2021,0.0,110.35,176.0
2021-07-02 06:10:00+00:00,symbol_transaction,BUY LONG 15.775956729784033 KUCOIN-UNFIUSDT 5.883 02/07/2021,92.90276339476078,0.0,83.09968074845217
2021-07-02 06:16:00+00:00,symbol_transaction,SELL LONG 18.733748728682592 KUCOIN-UNFIUSDT 5.888 02/07/2021,0.0,110.19,193.29
2021-07-02 06:19:00+00:00,symbol_transaction,SELL LONG 18.90256018071407 KUCOIN-UNFIUSDT 5.77 02/07/2021,0.0,108.96,302.25
2021-07-02 06:20:00+00:00,symbol_transaction,BUY LONG 15.836491555157144 KUCOIN-UNFIUSDT 5.77 02/07/2021,91.46793282952997,0.0,210.78446059136826
2021-07-02 06:32:00+00:00,symbol_transaction,BUY LONG 15.822303405945137 KUCOIN-UNFIUSDT 5.79 02/07/2021,91.70274785714275,0.0,119.0817127342255
2021-07-02 07:06:00+00:00,symbol_transaction,BUY LONG 15.811537709288356 KUCOIN-UNFIUSDT 5.816 02/07/2021,92.0518632205383,0.0,27.02984951368721
2021-07-02 08:09:00+00:00,symbol_transaction,SELL LONG 18.738107302617124 KUCOIN-UNFIUSDT 5.899 02/07/2021,0.0,110.43,137.46
2021-07-02 09:26:00+00:00,symbol_transaction,SELL LONG 19.269025135600582 KUCOIN-UNFIUSDT 5.715 02/07/2021,0.0,110.01,247.47
2021-07-02 10:21:00+00:00,symbol_transaction,BUY LONG 15.906601223620017 KUCOIN-UNFIUSDT 5.673 02/07/2021,90.32838689033795,0.0,157.1393776778169
2021-07-02 12:42:00+00:00,symbol_transaction,BUY LONG 15.877007141224462 KUCOIN-UNFIUSDT 5.731 02/07/2021,91.08211905428375,0.0,66.05725862353314
2021-07-02 13:10:00+00:00,symbol_transaction,SELL LONG 18.983268575399485 KUCOIN-UNFIUSDT 5.807 02/07/2021,0.0,110.13,176.18
2021-07-02 14:46:00+00:00,symbol_transaction,SELL LONG 18.770309173800495 KUCOIN-UNFIUSDT 5.914 02/07/2021,0.0,110.9,287.08
2021-07-02 15:02:00+00:00,symbol_transaction,BUY LONG 15.851444761399147 KUCOIN-UNFIUSDT 5.884 02/07/2021,93.36317087704866,0.0,193.71629336861417
2021-07-02 16:24:00+00:00,symbol_transaction,SELL LONG 18.74099318495459 KUCOIN-UNFIUSDT 5.914 02/07/2021,0.0,110.72,304.44
2021-07-02 17:19:00+00:00,symbol_transaction,SELL LONG 18.808870839828366 KUCOIN-UNFIUSDT 5.883 02/07/2021,0.0,110.54,414.98
2021-07-02 17:20:00+00:00,symbol_transaction,SELL LONG 18.81179571896322 KUCOIN-UNFIUSDT 5.883 02/07/2021,0.0,110.56,525.54
2021-07-02 17:22:00+00:00,symbol_transaction,SELL LONG 18.814697508680442 KUCOIN-UNFIUSDT 5.88 02/07/2021,0.0,110.52,636.06
2021-07-02 17:28:00+00:00,symbol_transaction,SELL LONG 18.79273578193605 KUCOIN-UNFIUSDT 5.881 02/07/2021,0.0,110.41,746.47
2021-07-02 17:35:00+00:00,symbol_transaction,BUY LONG 15.664748971512674 KUCOIN-UNFIUSDT 6.01 02/07/2021,94.23928646010997,0.0,652.2308153387576
2021-07-02 17:36:00+00:00,symbol_transaction,BUY LONG 15.55488948360119 KUCOIN-UNFIUSDT 6.04 02/07/2021,94.04548401343214,0.0,558.1853313253255
2021-07-02 18:25:00+00:00,symbol_transaction,BUY LONG 15.850118433315947 KUCOIN-UNFIUSDT 5.819 02/07/2021,92.32407100262895,0.0,465.8612603226965
